# EXCEPTIONS FOR PCRE RULES THAT CORRECT "MNET", "EMNT", "WIHT", "OTU", "TEH", "HTE", "EDN", "HSO", "LWO", "IGN", "EI"
aanleiding	aanleiding
abasedness	abasedness
abashedness	abashedness
abeigh	abeigh
abigei	abigei
abjectedness	abjectedness
ableism	ableism
ableisms	ableisms
ableist	ableist
ableists	ableists
abreid	abreid
abreise	abreise
abseil	abseil
abseiled	abseiled
abseiling	abseiling
abseils	abseils
absenteeism	absenteeism
absentmindedness	absentmindedness
absorbedness	absorbedness
abstractedness	abstractedness
abteilung	abteilung
abuleia	abuleia
abulyeit	abulyeit
abwesenheit	abwesenheit
acanthodei	acanthodei
accueil	accueil
accueilli	accueilli
accueillit	accueillit
accursedness	accursedness
accustomedness	accustomedness
aceite	aceite
aceituna	aceituna
acetylenediurein	acetylenediurein
acetyltropeine	acetyltropeine
acheilary	acheilary
acheilia	acheilia
acheilous	acheilous
acheiria	acheiria
acheirous	acheirous
acheirus	acheirus
achilleid	achilleid
achillein	achillein
achilleine	achilleine
achtehalber	achtehalber
achtel	achtel
achtelthaler	achtelthaler
achter	achter
achterveld	achterveld
acinotubular	acinotubular
acipenseroidei	acipenseroidei
acleidian	acleidian
acleistocardia	acleistocardia
acleistous	acleistous
acmaeidae	acmaeidae
acneiform	acneiform
acquaintedness	acquaintedness
acraein	acraein
acraeinae	acraeinae
acrolein	acrolein
acroleins	acroleins
acropoleis	acropoleis
aculei	aculei
aculeiform	aculeiform
adaptedness	adaptedness
addictedness	addictedness
addleheadedness	addleheadedness
addlepatedness	addlepatedness
adeleidae	adeleidae
adelheid	adelheid
adigei	adigei
adsignification	adsignification
adsignify	adsignify
advancedness	advancedness
advisedness	advisedness
aeipathy	aeipathy
aeneid	aeneid
affectedness	affectedness
affeir	affeir
afflictedness	afflictedness
affreight	affreight
affreighter	affreighter
affreightment	affreightment
affrighted	affrighted
affrightedly	affrightedly
affrighter	affrighter
affrontedness	affrontedness
afscheid	afscheid
afterthoughted	afterthoughted
agalwood	agalwood
agalwoods	agalwoods
agapeic	agapeic
agapeically	agapeically
agedness	agedness
agednesses	agednesses
ageing	ageing
ageings	ageings
ageism	ageism
ageisms	ageisms
ageist	ageist
ageists	ageists
aggrievedness	aggrievedness
agreeing	agreeing
agreeingly	agreeingly
agreing	agreing
aheight	aheight
ahtena	ahtena
airfreight	airfreight
airfreighter	airfreighter
aischrolatreia	aischrolatreia
akenobeite	akenobeite
albeit	albeit
aldeia	aldeia
aleikoum	aleikoum
aleikum	aleikum
aleiptes	aleiptes
aleiptic	aleiptic
alethopteis	alethopteis
alexandreid	alexandreid
alexei	alexei
alighted	alighted
alighten	alighten
align	align
aligned	aligned
aligner	aligner
aligners	aligners
aligning	aligning
alignment	alignment
alignments	alignments
aligns	aligns
alinotum	alinotum
allein	allein
allerlei	allerlei
allezeit	allezeit
allgemein	allgemein
allgemeine	allgemeine
allgemeinen	allgemeinen
allgemeiner	allgemeiner
allgemeinheit	allgemeinheit
allocaffeine	allocaffeine
allocheiria	allocheiria
allogeneic	allogeneic
allogeneity	allogeneity
allotheism	allotheism
allotheist	allotheist
allotheistic	allotheistic
alloxyproteic	alloxyproteic
allwork	allwork
allworthy	allworthy
almeidina	almeidina
almoign	almoign
alnein	alnein
alqueire	alqueire
alsweill	alsweill
althaein	althaein
althein	althein
altheine	altheine
alzheimer	alzheimer
amazedness	amazedness
ambreic	ambreic
ambrein	ambrein
ameiosis	ameiosis
ameiotic	ameiotic
ameiuridae	ameiuridae
ameiurus	ameiurus
ameiva	ameiva
amenorrheic	amenorrheic
amenorrhoeic	amenorrhoeic
amerveil	amerveil
amidocaffeine	amidocaffeine
amioidei	amioidei
amotus	amotus
ampangabeite	ampangabeite
amrei	amrei
amueixa	amueixa
anagignoskomena	anagignoskomena
anaheim	anaheim
anapeiratic	anapeiratic
anapneic	anapneic
anapnoeic	anapnoeic
anapodeictic	anapodeictic
anaseismic	anaseismic
anazoturia	anazoturia
anconei	anconei
andererseits	andererseits
androgyneity	androgyneity
angelegenheit	angelegenheit
angelegenheiten	angelegenheiten
animotheism	animotheism
aniseikonia	aniseikonia
aniseikonic	aniseikonic
ankylocheilia	ankylocheilia
anotus	anotus
anseis	anseis
antehall	antehall
antehistoric	antehistoric
antehuman	antehuman
antehypophysis	antehypophysis
anteil	anteil
anteing	anteing
anteinitial	anteinitial
antesignani	antesignani
antesignanus	antesignanus
antheia	antheia
anthropomorphotheist	anthropomorphotheist
anthropotheism	anthropotheism
anthropotheist	anthropotheist
anthropotheistic	anthropotheistic
antiatheism	antiatheism
antiatheist	antiatheist
antiatheistic	antiatheistic
antiatheistical	antiatheistical
antiatheistically	antiatheistically
antifideism	antifideism
antiforeign	antiforeign
antiforeignism	antiforeignism
antignostic	antignostic
antignostical	antignostical
antigonorrheic	antigonorrheic
antihemorrheidal	antihemorrheidal
antimallein	antimallein
antipleion	antipleion
antipreparedness	antipreparedness
antiquatedness	antiquatedness
antiseismic	antiseismic
antitheism	antitheism
antitheist	antitheist
antitheistic	antitheistic
antitheistical	antitheistical
antitheistically	antitheistically
antiturnpikeism	antiturnpikeism
antsigne	antsigne
aotus	aotus
apartheid	apartheid
apatheia	apatheia
apeiron	apeiron
apeirophobia	apeirophobia
apneic	apneic
apnoeic	apnoeic
apocaffeine	apocaffeine
apocodeine	apocodeine
apodedeipna	apodedeipna
apodeictic	apodeictic
apodeictical	apodeictical
apodeictically	apodeictically
apodeipna	apodeipna
apodeipnon	apodeipnon
apodeixis	apodeixis
apogaeic	apogaeic
apogeic	apogeic
apoturmeric	apoturmeric
appareil	appareil
appareils	appareils
apperceive	apperceive
apperceived	apperceived
apperceiving	apperceiving
appliqueing	appliqueing
approvedness	approvedness
apuleius	apuleius
aqueity	aqueity
aqueoigneous	aqueoigneous
aquileia	aquileia
araignee	araignee
araneid	araneid
araneida	araneida
araneidal	araneidal
araneidan	araneidan
araneids	araneids
araneiform	araneiform
araneiformes	araneiformes
araneiformia	araneiformia
aranein	aranein
araneina	araneina
arbeid	arbeid
arbeit	arbeit
arbeiten	arbeiten
arbeiter	arbeiter
arbeitete	arbeitete
archdeceiver	archdeceiver
archeion	archeion
archicleistogamous	archicleistogamous
archicleistogamy	archicleistogamy
archtempter	archtempter
ardeid	ardeid
ardeidae	ardeidae
areic	areic
areito	areito
argentoproteinum	argentoproteinum
aristeia	aristeia
aristeides	aristeides
arleigh	arleigh
arnheim	arnheim
aroeira	aroeira
arraign	arraign
arraignability	arraignability
arraignable	arraignable
arraignableness	arraignableness
arraigned	arraigned
arraigner	arraigner
arraigning	arraigning
arraignment	arraignment
arraignments	arraignments
arraigns	arraigns
arseniopleite	arseniopleite
arsenotungstates	arsenotungstates
arsenotungstic	arsenotungstic
arthrocleisis	arthrocleisis
arthrosteitis	arthrosteitis
asarotum	asarotum
asclepieion	asclepieion
aseismatic	aseismatic
aseismic	aseismic
aseismicity	aseismicity
aseitas	aseitas
aseity	aseity
aselgeia	aselgeia
ashamedness	ashamedness
ashleigh	ashleigh
aspidiotus	aspidiotus
aspidoganoidei	aspidoganoidei
asseize	asseize
assheadedness	assheadedness
assign	assign
assignability	assignability
assignable	assignable
assignably	assignably
assignat	assignat
assignation	assignation
assignations	assignations
assignats	assignats
assigned	assigned
assignee	assignee
assignees	assignees
assigneeship	assigneeship
assigner	assigner
assigners	assigners
assigning	assigning
assignment	assignment
assignments	assignments
assignor	assignor
assignors	assignors
assigns	assigns
associatedness	associatedness
assortedness	assortedness
assuredness	assuredness
asteism	asteism
astraeid	astraeid
astraeidae	astraeidae
astraeiform	astraeiform
ateleiosis	ateleiosis
atheism	atheism
atheisms	atheisms
atheist	atheist
atheistic	atheistic
atheistical	atheistical
atheistically	atheistically
atheisticalness	atheisticalness
atheisticness	atheisticness
atheists	atheists
atheize	atheize
atheizer	atheizer
athletehood	athletehood
atteignit	atteignit
atteindre	atteindre
atteint	atteint
atteinte	atteinte
aufeinander	aufeinander
aufmerksamkeit	aufmerksamkeit
aurei	aurei
aureity	aureity
aurignacian	aurignacian
auseinander	auseinander
autoignition	autoignition
autolimnetic	autolimnetic
autoreinfusion	autoreinfusion
autosign	autosign
autotheism	autotheism
autotheist	autotheist
autotuberculin	autotuberculin
autoturning	autoturning
avignonese	avignonese
avowedness	avowedness
awedness	awedness
aweigh	aweigh
aweing	aweing
awlwort	awlwort
awlworts	awlworts
azogallein	azogallein
azoprotein	azoprotein
azoturia	azoturia
azoturias	azoturias
baccheion	baccheion
backhandedness	backhandedness
backspeir	backspeir
bacterioprotein	bacterioprotein
baign	baign
baignet	baignet
baigneuse	baigneuse
baigneuses	baigneuses
baignoire	baignoire
bailwood	bailwood
bakalei	bakalei
balancedness	balancedness
baldpatedness	baldpatedness
balei	balei
baleinier	baleinier
baleise	baleise
baltei	baltei
baltetei	baltetei
bantamweight	bantamweight
bantamweights	bantamweights
barbecueing	barbecueing
barbedness	barbedness
barbeiro	barbeiro
barefacedness	barefacedness
bareheadedness	bareheadedness
baseheartedness	baseheartedness
basileis	basileis
bathylimnetic	bathylimnetic
bathyseism	bathyseism
batoidei	batoidei
beadleism	beadleism
beardedness	beardedness
bechignoned	bechignoned
bedighted	bedighted
bednighted	bednighted
bednights	bednights
beeish	beeish
beeishness	beeishness
beetleheadedness	beetleheadedness
beforehandedness	beforehandedness
befreight	befreight
befreit	befreit
befreiung	befreiung
begebenheiten	begebenheiten
begeisterung	begeisterung
begleiten	begleiten
begleiter	begleiter
begleitet	begleitet
begleitete	begleitete
begreifen	begreifen
begreiflich	begreiflich
begreift	begreift
beheira	beheira
bei	bei
beice	beice
beid	beid
beide	beide
beiden	beiden
beider	beider
beides	beides
beifall	beifall
beige	beige
beigel	beigel
beiges	beiges
beigne	beigne
beignes	beignes
beignet	beignet
beignets	beignets
beigy	beigy
beijing	beijing
beild	beild
beim	beim
bein	bein
bein'	bein'
beinahe	beinahe
beine	beine
beinen	beinen
being	being
being's	being's
beingless	beingless
beingness	beingness
beings	beings
beinked	beinked
beinly	beinly
beinness	beinness
beira	beira
beirut	beirut
beisa	beisa
beisammen	beisammen
beisance	beisance
beiseite	beiseite
beispiel	beispiel
beispiele	beispiele
beknighted	beknighted
beknottedness	beknottedness
belatedness	belatedness
beleidigt	beleidigt
belleisle	belleisle
bellwood	bellwood
bellwort	bellwort
bellworts	bellworts
beloeilite	beloeilite
beneighbored	beneighbored
benighted	benighted
benightedly	benightedly
benightedness	benightedness
benighten	benighten
benighter	benighter
benign	benign
benignancies	benignancies
benignancy	benignancy
benignant	benignant
benignantly	benignantly
benignities	benignities
benignity	benignity
benignly	benignly
benignness	benignness
benumbedness	benumbedness
benzein	benzein
bereich	bereich
bereid	bereid
bereiken	bereiken
bereikt	bereikt
bereit	bereit
bereiten	bereiten
bereitet	bereitet
bereits	bereits
bergenheim	bergenheim
berkeleian	berkeleian
berkeleianism	berkeleianism
bernstein	bernstein
berycoidei	berycoidei
beschaffenheit	beschaffenheit
bescheiden	bescheiden
beschreibung	beschreibung
beseige	beseige
besottedness	besottedness
bespottedness	bespottedness
bestimmtheit	bestimmtheit
beveil	beveil
beweis	beweis
beweise	beweise
beweisen	beweisen
beweist	beweist
bewilderedness	bewilderedness
bewitchedness	bewitchedness
bewusstsein	bewusstsein
bewusstseins	bewusstseins
bewußtsein	bewußtsein
bewußtseins	bewußtseins
bezeichnen	bezeichnen
bezeichnet	bezeichnet
bezeichnung	bezeichnung
biedermeier	biedermeier
bienveillance	bienveillance
bigheartedness	bigheartedness
bighted	bighted
bigness	bigness
bignesses	bignesses
bignonia	bignonia
bignoniaceae	bignoniaceae
bignoniaceous	bignoniaceous
bignoniad	bignoniad
bignonias	bignonias
bignou	bignou
bigotedness	bigotedness
bigwiggedness	bigwiggedness
bindheimite	bindheimite
bingeing	bingeing
birdieing	birdieing
bisbeeite	bisbeeite
bisweilen	bisweilen
bitheism	bitheism
bitterheartedness	bitterheartedness
blackheartedness	blackheartedness
blakeite	blakeite
blankmindedness	blankmindedness
blearedness	blearedness
blearyeyedness	blearyeyedness
bleibe	bleibe
bleiben	bleiben
bleibt	bleibt
bleich	bleich
bleinerite	bleinerite
blenheim	blenheim
blessedness	blessedness
blighted	blighted
blighter	blighter
blighters	blighters
blindfoldedness	blindfoldedness
bloatedness	bloatedness
blockheadedness	blockheadedness
bloemfontein	bloemfontein
bloodedness	bloodedness
bloodstainedness	bloodstainedness
blueing	blueing
blueings	blueings
blueish	blueish
blunderheadedness	blunderheadedness
blurredness	blurredness
bobsleigh	bobsleigh
bodleian	bodleian
bodyweight	bodyweight
boeing	boeing
boldfacedness	boldfacedness
boldheartedness	boldheartedness
boleite	boleite
bollworm	bollworm
bollworms	bollworms
boneheadedness	boneheadedness
boodleism	boodleism
boodleize	boodleize
boredness	boredness
boreiad	boreiad
boreism	boreism
borotungstate	borotungstate
borotungstic	borotungstic
bosheit	bosheit
botein	botein
bothsidedness	bothsidedness
botuliform	botuliform
botulin	botulin
botulinal	botulinal
botulins	botulins
botulinum	botulinum
botulinus	botulinus
botulinuses	botulinuses
botulism	botulism
botulisms	botulisms
botulismus	botulismus
boughten	boughten
boundedness	boundedness
bourguignonne	bourguignonne
bourignian	bourignian
bourignianism	bourignianism
bourignianist	bourignianist
bourignonism	bourignonism
bourignonist	bourignonist
bouteille	bouteille
bouteilles	bouteilles
bowedness	bowedness
bowleggedness	bowleggedness
brachioganoidei	brachioganoidei
brachysclereid	brachysclereid
bracteiform	bracteiform
bradyseism	bradyseism
bradyseismal	bradyseismal
bradyseismic	bradyseismic
bradyseismical	bradyseismical
bradyseismism	bradyseismism
branchedness	branchedness
brandeis	brandeis
brasilein	brasilein
braunschweiger	braunschweiger
brawnedness	brawnedness
brazenfacedness	brazenfacedness
brazilein	brazilein
brazilwood	brazilwood
breastheight	breastheight
brei	brei
breird	breird
breislakite	breislakite
breit	breit
breite	breite
breiten	breiten
breithauptite	breithauptite
breitmann	breitmann
bretschneideraceae	bretschneideraceae
brighten	brighten
brightened	brightened
brightener	brightener
brighteners	brighteners
brightening	brightening
brightens	brightens
brighter	brighter
brightest	brightest
brighteyes	brighteyes
briseis	briseis
broigne	broigne
brokenheartedness	brokenheartedness
bromeigon	bromeigon
bromeikon	bromeikon
bromoprotein	bromoprotein
brotula	brotula
brotulid	brotulid
brotulidae	brotulidae
brotuliform	brotuliform
brunei	brunei
buddleia	buddleia
buddleias	buddleias
buhlwork	buhlwork
buhlworks	buhlworks
bulbotuber	bulbotuber
bulldoggedness	bulldoggedness
bulletheadedness	bulletheadedness
bullfighter	bullfighter
bullfighters	bullfighters
bullheadedness	bullheadedness
bullwork	bullwork
bullwort	bullwort
burkei	burkei
burleigh	burleigh
burrheadedness	burrheadedness
bushelwoman	bushelwoman
bushfighter	bushfighter
butein	butein
byegaein	byegaein
cabbageheadedness	cabbageheadedness
cabureiba	cabureiba
cacei	cacei
cachoeira	cachoeira
cadiueio	cadiueio
caducecei	caducecei
caducei	caducei
caffeic	caffeic
caffein	caffein
caffeina	caffeina
caffeine	caffeine
caffeines	caffeines
caffeinic	caffeinic
caffeinism	caffeinism
caffeins	caffeins
caffeism	caffeism
calcanei	calcanei
calcannei	calcannei
calceiform	calceiform
calculatedness	calculatedness
callisteia	callisteia
cameist	cameist
campaign	campaign
campaigned	campaigned
campaigner	campaigner
campaigners	campaigners
campaigning	campaigning
campaigns	campaigns
campignian	campignian
campodeid	campodeid
campodeidae	campodeidae
campodeiform	campodeiform
camponotus	camponotus
candlelighted	candlelighted
candlelighter	candlelighter
cankeredness	cankeredness
canoeing	canoeing
canoeiro	canoeiro
canoeist	canoeist
canoeists	canoeists
capoeira	capoeira
carlyleian	carlyleian
caroigne	caroigne
cartilaginei	cartilaginei
carvoeira	carvoeira
caseic	caseic
casein	casein
caseinate	caseinate
caseine	caseine
caseinogen	caseinogen
caseins	caseins
cassiepeia	cassiepeia
cassiopeia	cassiopeia
cassiopeian	cassiopeian
cassiopeid	cassiopeid
cassiopeium	cassiopeium
casteism	casteism
casteisms	casteisms
catapleiite	catapleiite
catchweight	catchweight
catesbeiana	catesbeiana
ceiba	ceiba
ceibas	ceibas
ceibo	ceibo
ceibos	ceibos
ceil	ceil
ceile	ceile
ceiled	ceiled
ceiler	ceiler
ceilers	ceilers
ceili	ceili
ceilidh	ceilidh
ceilidhe	ceilidhe
ceilidhs	ceilidhs
ceiling	ceiling
ceilinged	ceilinged
ceilings	ceilings
ceilingward	ceilingward
ceilingwards	ceilingwards
ceilis	ceilis
ceilometer	ceilometer
ceils	ceils
ceint	ceint
ceinte	ceinte
ceinture	ceinture
ceintures	ceintures
celebratedness	celebratedness
centeredness	centeredness
centrotus	centrotus
cephalotus	cephalotus
cepheid	cepheid
cepheids	cepheids
cerasein	cerasein
cercueil	cercueil
cerulein	cerulein
ceruleite	ceruleite
cerulignol	cerulignol
cerulignone	cerulignone
chaldaei	chaldaei
champaign	champaign
champignon	champignon
champignons	champignons
changedness	changedness
chargedness	chargedness
charicleia	charicleia
chasseing	chasseing
chassignite	chassignite
chausseemeile	chausseemeile
checkrein	checkrein
checkweigher	checkweigher
checkweighman	checkweighman
checkweighmen	checkweighmen
cheiceral	cheiceral
cheilanthes	cheilanthes
cheilion	cheilion
cheilitis	cheilitis
cheilodipteridae	cheilodipteridae
cheilodipterus	cheilodipterus
cheiloplasties	cheiloplasties
cheiloplasty	cheiloplasty
cheilostomata	cheilostomata
cheilostomatous	cheilostomatous
cheilotomies	cheilotomies
cheilotomy	cheilotomy
cheimaphobia	cheimaphobia
cheimatophobia	cheimatophobia
cheir	cheir
cheiragra	cheiragra
cheiranthus	cheiranthus
cheirogaleus	cheirogaleus
cheiroglossa	cheiroglossa
cheirognomy	cheirognomy
cheirography	cheirography
cheirolin	cheirolin
cheiroline	cheiroline
cheirology	cheirology
cheiromancy	cheiromancy
cheiromegaly	cheiromegaly
cheiropatagium	cheiropatagium
cheiropod	cheiropod
cheiropodist	cheiropodist
cheiropody	cheiropody
cheiropompholyx	cheiropompholyx
cheiroptera	cheiroptera
cheiropterygium	cheiropterygium
cheirosophy	cheirosophy
cheirospasm	cheirospasm
cheirotherium	cheirotherium
chervonei	chervonei
chesteine	chesteine
chickenheartedness	chickenheartedness
chignon	chignon
chignoned	chignoned
chignons	chignons
chimaeroidei	chimaeroidei
chinoleine	chinoleine
chivareeing	chivareeing
chivareing	chivareing
chlorophaeite	chlorophaeite
choleic	choleic
choleine	choleine
choleinic	choleinic
cholophaein	cholophaein
cholophein	cholophein
chondroganoidei	chondroganoidei
chondroprotein	chondroprotein
chondrostei	chondrostei
chordeiles	chordeiles
chorei	chorei
choreic	choreic
choreiform	choreiform
chowderheadedness	chowderheadedness
chrematheism	chrematheism
chromoprotein	chromoprotein
chronodeik	chronodeik
chryseis	chryseis
chrysopoeia	chrysopoeia
chteau	chteau
chubbedness	chubbedness
chuckleheadedness	chuckleheadedness
cicisbei	cicisbei
cicisbeism	cicisbeism
cinclidotus	cinclidotus
cinnamein	cinnamein
cisleithan	cisleithan
civilisedness	civilisedness
civilizedness	civilizedness
clarkeite	clarkeite
clarkeites	clarkeites
claughted	claughted
cleanhandedness	cleanhandedness
clearedness	clearedness
clearheadedness	clearheadedness
clearsighted	clearsighted
clearsightedness	clearsightedness
cleidagra	cleidagra
cleidarthritis	cleidarthritis
cleidocostal	cleidocostal
cleidocranial	cleidocranial
cleidohyoid	cleidohyoid
cleidoic	cleidoic
cleidomancy	cleidomancy
cleidomastoid	cleidomastoid
cleidorrhexis	cleidorrhexis
cleidoscapular	cleidoscapular
cleidosternal	cleidosternal
cleidotomy	cleidotomy
cleidotripsy	cleidotripsy
cleinias	cleinias
cleistocarp	cleistocarp
cleistocarpous	cleistocarpous
cleistogamic	cleistogamic
cleistogamically	cleistogamically
cleistogamous	cleistogamous
cleistogamously	cleistogamously
cleistogamy	cleistogamy
cleistogene	cleistogene
cleistogenous	cleistogenous
cleistogeny	cleistogeny
cleistotcia	cleistotcia
cleistothecia	cleistothecia
cleistothecium	cleistothecium
cleistothecopsis	cleistothecopsis
cleithral	cleithral
cleithrum	cleithrum
cleveite	cleveite
cleveites	cleveites
clipei	clipei
cliqueier	cliqueier
cliqueiest	cliqueiest
closefistedness	closefistedness
clottedness	clottedness
cloture	cloture
clotured	clotured
clotures	clotures
cloturing	cloturing
cloyedness	cloyedness
clueing	clueing
clupeid	clupeid
clupeidae	clupeidae
clupeids	clupeids
clupeiform	clupeiform
clupein	clupein
clupeine	clupeine
clupeiod	clupeiod
clupeodei	clupeodei
clypei	clypei
clypeiform	clypeiform
cneius	cneius
coassignee	coassignee
cobenignity	cobenignity
cocaigne	cocaigne
cocceian	cocceian
cocceianism	cocceianism
coccosteid	coccosteid
coccosteidae	coccosteidae
cochleiform	cochleiform
cochleitis	cochleitis
cockaigne	cockaigne
cockeyedness	cockeyedness
cockfighter	cockfighter
cockneian	cockneian
cockneity	cockneity
cocksureism	cocksureism
codeia	codeia
codeias	codeias
codein	codein
codeina	codeina
codeinas	codeinas
codeine	codeine
codeines	codeines
codeins	codeins
codesign	codesign
codesigned	codesigned
codesigning	codesigning
codesigns	codesigns
coetaneity	coetaneity
coevalneity	coevalneity
cofighter	cofighter
cofreighter	cofreighter
coheartedness	coheartedness
coheir	coheir
coheiress	coheiress
coheirs	coheirs
coheirship	coheirship
coign	coign
coigne	coigne
coigned	coigned
coignes	coignes
coigning	coigning
coigns	coigns
coigny	coigny
coinstantaneity	coinstantaneity
coldbloodedness	coldbloodedness
coldheartedness	coldheartedness
collectedness	collectedness
columbeia	columbeia
columbeion	columbeion
combinedness	combinedness
commandedness	commandedness
committedness	committedness
committeeism	committeeism
commoigne	commoigne
commonplaceism	commonplaceism
compactedness	compactedness
completedness	completedness
complexedness	complexedness
complicatedness	complicatedness
composedness	composedness
compoundedness	compoundedness
concealedness	concealedness
conceit	conceit
conceited	conceited
conceitedly	conceitedly
conceitedness	conceitedness
conceiting	conceiting
conceitless	conceitless
conceits	conceits
conceity	conceity
conceivability	conceivability
conceivable	conceivable
conceivableness	conceivableness
conceivably	conceivably
conceive	conceive
conceived	conceived
conceiver	conceiver
conceivers	conceivers
conceives	conceives
conceiving	conceiving
concernedness	concernedness
concertedness	concertedness
concertmeister	concertmeister
condensedness	condensedness
condign	condign
condigness	condigness
condignity	condignity
condignly	condignly
condignness	condignness
coneighboring	coneighboring
coneine	coneine
confinedness	confinedness
confirmedness	confirmedness
confoundedness	confoundedness
confusedness	confusedness
congealedness	congealedness
congeeing	congeeing
congeing	congeing
congestedness	congestedness
conicein	conicein
coniceine	coniceine
connectedness	connectedness
consecratedness	consecratedness
conseil	conseil
conseille	conseille
conseiller	conseiller
conseillers	conseillers
conseils	conseils
consentaneity	consentaneity
consign	consign
consignable	consignable
consignataries	consignataries
consignatary	consignatary
consignation	consignation
consignatory	consignatory
consigne	consigne
consigned	consigned
consignee	consignee
consignees	consignees
consigneeship	consigneeship
consigner	consigner
consignificant	consignificant
consignificate	consignificate
consignification	consignification
consignificative	consignificative
consignificator	consignificator
consignified	consignified
consignify	consignify
consignifying	consignifying
consigning	consigning
consignment	consignment
consignments	consignments
consignor	consignor
consignors	consignors
consigns	consigns
constrainedness	constrainedness
contemporaneity	contemporaneity
contentedness	contentedness
contignate	contignate
contignation	contignation
continuedness	continuedness
contortedness	contortedness
contractedness	contractedness
contradictedness	contradictedness
convexedness	convexedness
convincedness	convincedness
convolutedness	convolutedness
cooeeing	cooeeing
cooghneiorvlt	cooghneiorvlt
cookeite	cookeite
coolheadedness	coolheadedness
coolwort	coolwort
coorieing	coorieing
copei	copei
copeia	copeia
copyrighted	copyrighted
copyrighter	copyrighter
coralwort	coralwort
corbeil	corbeil
corbeille	corbeille
corbeilles	corbeilles
corbeils	corbeils
coreceiver	coreceiver
coreid	coreid
coreidae	coreidae
coreign	coreign
coreigner	coreigner
coreigns	coreigns
coresign	coresign
corneille	corneille
cornein	cornein
corneine	corneine
corneitis	corneitis
corocleisis	corocleisis
corporeity	corporeity
correctedness	correctedness
corroboreeing	corroboreeing
corruptedness	corruptedness
corteise	corteise
coryphaei	coryphaei
corypphaei	corypphaei
coseier	coseier
coseiest	coseiest
coseism	coseism
coseismal	coseismal
coseismic	coseismic
cosign	cosign
cosignatories	cosignatories
cosignatory	cosignatory
cosigned	cosigned
cosigner	cosigner
cosigners	cosigners
cosignificative	cosignificative
cosigning	cosigning
cosignitary	cosignitary
cosigns	cosigns
cosmotheism	cosmotheism
cosmotheist	cosmotheist
cosmotheistic	cosmotheistic
cosovereign	cosovereign
cosovereignty	cosovereignty
cotehardie	cotehardie
cotuit	cotuit
cotula	cotula
cotunnite	cotunnite
coturnix	coturnix
cotutor	cotutor
coueism	coueism
councilwoman	councilwoman
councilwomen	councilwomen
countercampaign	countercampaign
counterfeisance	counterfeisance
counterfeit	counterfeit
counterfeited	counterfeited
counterfeiter	counterfeiter
counterfeiters	counterfeiters
counterfeiting	counterfeiting
counterfeitly	counterfeitly
counterfeitment	counterfeitment
counterfeitness	counterfeitness
counterfeits	counterfeits
counterlighted	counterlighted
countersign	countersign
countersignal	countersignal
countersignature	countersignature
countersignatures	countersignatures
countersigned	countersigned
countersigning	countersigning
countersigns	countersigns
countersleight	countersleight
counterweigh	counterweigh
counterweighed	counterweighed
counterweighing	counterweighing
counterweight	counterweight
counterweighted	counterweighted
counterweights	counterweights
countrifiedness	countrifiedness
countryfiedness	countryfiedness
cozeier	cozeier
cozeiest	cozeiest
crabbedness	crabbedness
crackbrainedness	crackbrainedness
crackedness	crackedness
crackpottedness	crackpottedness
craggedness	craggedness
crampedness	crampedness
crazedness	crazedness
createdness	createdness
crednerite	crednerite
creighton	creighton
creirgist	creirgist
creoleize	creoleize
crepeier	crepeier
crepeiest	crepeiest
crestmoreite	crestmoreite
crewelwork	crewelwork
cricotus	cricotus
croceic	croceic
crocein	crocein
croceine	croceine
croceines	croceines
croceins	croceins
crookedness	crookedness
croquignole	croquignole
crossgrainedness	crossgrainedness
crosslighted	crosslighted
crowdedness	crowdedness
cruiserweight	cruiserweight
cruzeiro	cruzeiro
cruzeiros	cruzeiros
cryptocleidus	cryptocleidus
cryptodeist	cryptodeist
crystalwort	crystalwort
ctenoidei	ctenoidei
cubocuneiform	cubocuneiform
cudeigh	cudeigh
cueillir	cueillir
cueing	cueing
cueist	cueist
cunei	cunei
cuneiform	cuneiform
cuneiformist	cuneiformist
cunenei	cunenei
cuprein	cuprein
cupreine	cupreine
cuprotungstite	cuprotungstite
curledness	curledness
cursedness	cursedness
curtein	curtein
curvedness	curvedness
cussedness	cussedness
cycloganoidei	cycloganoidei
cycloidei	cycloidei
cypraeid	cypraeid
cypraeidae	cypraeidae
cypraeiform	cypraeiform
cystein	cystein
cysteine	cysteine
cysteines	cysteines
cysteinic	cysteinic
cysteins	cysteins
cystignathidae	cystignathidae
cystignathine	cystignathine
d'atteindre	d'atteindre
d'oeil	d'oeil
d'orgueil	d'orgueil
dabei	dabei
daheim	daheim
daidzein	daidzein
dankbarkeit	dankbarkeit
dappledness	dappledness
darkheartedness	darkheartedness
darraign	darraign
darrein	darrein
dasein	dasein
daseins	daseins
datedness	datedness
daubreeite	daubreeite
daubreite	daubreite
daughter	daughter
daughterhood	daughterhood
daughterkin	daughterkin
daughterless	daughterless
daughterlike	daughterlike
daughterliness	daughterliness
daughterling	daughterling
daughterly	daughterly
daughters	daughters
daughtership	daughtership
daylighted	daylighted
dazedness	dazedness
deadheartedness	deadheartedness
deadweight	deadweight
debasedness	debasedness
debauchedness	debauchedness
debeige	debeige
decaffeinate	decaffeinate
decaffeinated	decaffeinated
decaffeinates	decaffeinates
decaffeinating	decaffeinating
decaffeinize	decaffeinize
decayedness	decayedness
deceit	deceit
deceitful	deceitful
deceitfully	deceitfully
deceitfulness	deceitfulness
deceits	deceits
deceivability	deceivability
deceivable	deceivable
deceivableness	deceivableness
deceivably	deceivably
deceivance	deceivance
deceive	deceive
deceived	deceived
deceiver	deceiver
deceivers	deceivers
deceives	deceives
deceiving	deceiving
deceivingly	deceivingly
decidedness	decidedness
declaredness	declaredness
declinedness	declinedness
decreeing	decreeing
decreing	decreing
dedignation	dedignation
defeise	defeise
defeit	defeit
defiledness	defiledness
deformedness	deformedness
degradedness	degradedness
degreeing	degreeing
dehydrosparteine	dehydrosparteine
dei	dei
deia	deia
deicate	deicate
deice	deice
deiced	deiced
deicer	deicer
deicers	deicers
deices	deices
deicidal	deicidal
deicide	deicide
deicides	deicides
deicing	deicing
deictic	deictic
deictical	deictical
deictically	deictically
deictics	deictics
deid	deid
deidealize	deidealize
deidesheimer	deidesheimer
deific	deific
deifical	deifical
deification	deification
deifications	deifications
deificatory	deificatory
deified	deified
deifier	deifier
deifiers	deifiers
deifies	deifies
deiform	deiform
deiformity	deiformity
deify	deify
deifying	deifying
deign	deign
deigned	deigned
deigning	deigning
deignous	deignous
deigns	deigns
deil	deil
deils	deils
deimos	deimos
dein	dein
deincrustant	deincrustant
deinde	deinde
deindividualization	deindividualization
deindividualize	deindividualize
deindividuate	deindividuate
deindustrialization	deindustrialization
deindustrialize	deindustrialize
deine	deine
deinem	deinem
deinen	deinen
deiner	deiner
deines	deines
deink	deink
deino	deino
deinocephalia	deinocephalia
deinoceras	deinoceras
deinodon	deinodon
deinodontidae	deinodontidae
deinos	deinos
deinosaur	deinosaur
deinosauria	deinosauria
deinotherium	deinotherium
deinstitutionalization	deinstitutionalization
deinsularize	deinsularize
deintellectualization	deintellectualization
deintellectualize	deintellectualize
deionization	deionization
deionizations	deionizations
deionize	deionize
deionized	deionized
deionizer	deionizer
deionizes	deionizes
deionizing	deionizing
deipara	deipara
deiparous	deiparous
deiphobus	deiphobus
deipnodiplomatic	deipnodiplomatic
deipnophobia	deipnophobia
deipnosophism	deipnosophism
deipnosophist	deipnosophist
deipnosophistic	deipnosophistic
deipotent	deipotent
deir	deir
deirdre	deirdre
deirid	deirid
deis	deis
deiseal	deiseal
deisidaimonia	deisidaimonia
deisin	deisin
deism	deism
deisms	deisms
deist	deist
deistic	deistic
deistical	deistical
deistically	deistically
deisticalness	deisticalness
deists	deists
deitate	deitate
deities	deities
deity	deity
deityship	deityship
deixis	deixis
deixises	deixises
dejectedness	dejectedness
dekeing	dekeing
deleing	deleing
delighted	delighted
delightedly	delightedly
delightedness	delightedness
delighter	delighter
delignate	delignate
delignated	delignated
delignification	delignification
deltoidei	deltoidei
dementedness	dementedness
demiassignation	demiassignation
demiatheism	demiatheism
demiatheist	demiatheist
demideify	demideify
demideity	demideity
demisovereign	demisovereign
deoxyribonucleic	deoxyribonucleic
deoxyribonucleoprotein	deoxyribonucleoprotein
depeinct	depeinct
dephlegmedness	dephlegmedness
deploredness	deploredness
depravedness	depravedness
deraign	deraign
deraigned	deraigned
deraigning	deraigning
deraignment	deraignment
deraigns	deraigns
dereign	dereign
dereism	dereism
dereistic	dereistic
dereistically	dereistically
dergleichen	dergleichen
derivedness	derivedness
desertedness	desertedness
deservedness	deservedness
design	design
designable	designable
designado	designado
designate	designate
designated	designated
designates	designates
designating	designating
designation	designation
designations	designations
designative	designative
designator	designator
designators	designators
designatory	designatory
designatum	designatum
designed	designed
designedly	designedly
designedness	designedness
designee	designee
designees	designees
designer	designer
designers	designers
designful	designful
designfully	designfully
designfulness	designfulness
designing	designing
designingly	designingly
designless	designless
designlessly	designlessly
designlessness	designlessness
designment	designment
designs	designs
desiredness	desiredness
desoxyribonucleic	desoxyribonucleic
desoxyribonucleoprotein	desoxyribonucleoprotein
despisedness	despisedness
dessein	dessein
desseins	desseins
detachedness	detachedness
detailedness	detailedness
determinedness	determinedness
devein	devein
deveined	deveined
deveining	deveining
deveins	deveins
developedness	developedness
devilwood	devilwood
devotedness	devotedness
devoteeism	devoteeism
diaphaneity	diaphaneity
diarrheic	diarrheic
diarrhoeic	diarrhoeic
diathermaneity	diathermaneity
dicaeidae	dicaeidae
dichter	dichter
dicodeine	dicodeine
dieing	dieing
dietzeite	dietzeite
diffusedness	diffusedness
digestedness	digestedness
dighted	dighted
dighter	dighter
digitalein	digitalein
dignation	dignation
digne	digne
dignification	dignification
dignified	dignified
dignifiedly	dignifiedly
dignifiedness	dignifiedness
dignifies	dignifies
dignify	dignify
dignifying	dignifying
dignitarial	dignitarial
dignitarian	dignitarian
dignitaries	dignitaries
dignitary	dignitary
dignitas	dignitas
dignities	dignities
dignity	dignity
dignosce	dignosce
dignosle	dignosle
dignotion	dignotion
dihydrocupreine	dihydrocupreine
dilatedness	dilatedness
dilettanteish	dilettanteish
dilettanteism	dilettanteism
dilutedness	dilutedness
dimmedness	dimmedness
dimwittedness	dimwittedness
dingeing	dingeing
dinheiro	dinheiro
diomedeidae	diomedeidae
dioscorein	dioscorein
diphylleia	diphylleia
dipleidoscope	dipleidoscope
dipleiodoscope	dipleiodoscope
disaccustomedness	disaccustomedness
disadvantagedness	disadvantagedness
disaffectedness	disaffectedness
disagreeing	disagreeing
disagreing	disagreing
disalign	disalign
disaligned	disaligned
disaligning	disaligning
disalignment	disalignment
discoloredness	discoloredness
discomposedness	discomposedness
disconcertedness	disconcertedness
disconnectedness	disconnectedness
discontentedness	discontentedness
disdeceive	disdeceive
disdeify	disdeify
disdein	disdein
diseasedness	diseasedness
disengagedness	disengagedness
disguisedness	disguisedness
disgustedness	disgustedness
disheir	disheir
disinterestedness	disinterestedness
disjointedness	disjointedness
dislocatedness	dislocatedness
disloign	disloign
dismayedness	dismayedness
disordeine	disordeine
disorderedness	disorderedness
dispersedness	dispersedness
dispiritedness	dispiritedness
disposedness	disposedness
disquietedness	disquietedness
dissatisfiedness	dissatisfiedness
disseise	disseise
disseised	disseised
disseisee	disseisee
disseises	disseises
disseisor	disseisor
disseisoress	disseisoress
disseize	disseize
disseized	disseized
disseizee	disseizee
disseizes	disseizes
disseizin	disseizin
disseizor	disseizor
disseizoress	disseizoress
disseizure	disseizure
dissipatedness	dissipatedness
distemperedness	distemperedness
distendedness	distendedness
distortedness	distortedness
distractedness	distractedness
distraughted	distraughted
distressedness	distressedness
ditheism	ditheism
ditheisms	ditheisms
ditheist	ditheist
ditheistic	ditheistic
ditheistical	ditheistical
ditheists	ditheists
diureide	diureide
dividedness	dividedness
dochter	dochter
doggedness	doggedness
dohter	dohter
domnei	domnei
dottedness	dottedness
doublehandedness	doublehandedness
doubleheartedness	doubleheartedness
doughfaceism	doughfaceism
dowieism	dowieism
dowieite	dowieite
downheartedness	downheartedness
downweigh	downweigh
downweight	downweight
downweighted	downweighted
draggletailedness	draggletailedness
draughted	draughted
draughter	draughter
dreeing	dreeing
drei	drei
dreich	dreich
dreidel	dreidel
dreidels	dreidels
dreidl	dreidl
dreidls	dreidls
dreigh	dreigh
dreikanter	dreikanter
dreikanters	dreikanters
dreiling	dreiling
dreimal	dreimal
dreint	dreint
dreissensia	dreissensia
dreissiger	dreissiger
drighten	drighten
droefheid	droefheid
dromiceiidae	dromiceiidae
dromiceius	dromiceius
dudleigh	dudleigh
dunderheadedness	dunderheadedness
dunkelheit	dunkelheit
durcheinander	durcheinander
dyeing	dyeing
dyeings	dyeings
dynein	dynein
dyneins	dyneins
dyotheism	dyotheism
dysmenorrheic	dysmenorrheic
dyspneic	dyspneic
dyspnoeic	dyspnoeic
earmindedness	earmindedness
echeneid	echeneid
echeneidae	echeneidae
echeneidid	echeneidid
echeneididae	echeneididae
echeneidoid	echeneidoid
echeneis	echeneis
ecklein	ecklein
ectocuneiform	ectocuneiform
edeitis	edeitis
edelweiss	edelweiss
edelweisses	edelweisses
edna	edna
educatedness	educatedness
eelworm	eelworm
eelworms	eelworms
effeir	effeir
eggheadedness	eggheadedness
egotheism	egotheism
egremoigne	egremoigne
egueiite	egueiite
ehrgeiz	ehrgeiz
ei	ei
eichbaum	eichbaum
eichbergite	eichbergite
eichhornia	eichhornia
eichwaldite	eichwaldite
eicosane	eicosane
eid	eid
eide	eide
eident	eident
eidently	eidently
eider	eider
eiderdown	eiderdown
eiders	eiders
eidetic	eidetic
eidetically	eidetically
eidograph	eidograph
eidola	eidola
eidolic	eidolic
eidolism	eidolism
eidology	eidology
eidolology	eidolology
eidolon	eidolon
eidolons	eidolons
eidoptometry	eidoptometry
eidos	eidos
eidouranion	eidouranion
eier	eier
eifer	eifer
eifersucht	eifersucht
eiffel	eiffel
eifrig	eifrig
eigen	eigen
eigendom	eigendom
eigene	eigene
eigenen	eigenen
eigener	eigener
eigenes	eigenes
eigenfrequency	eigenfrequency
eigenfunction	eigenfunction
eigenlijk	eigenlijk
eigenmode	eigenmode
eigenschaft	eigenschaft
eigenschaften	eigenschaften
eigenspace	eigenspace
eigenstate	eigenstate
eigentlich	eigentlich
eigentliche	eigentliche
eigentlichen	eigentlichen
eigentum	eigentum
eigenvalue	eigenvalue
eigenvalues	eigenvalues
eigenvector	eigenvector
eigenvectors	eigenvectors
eigh	eigh
eight	eight
eightball	eightball
eightballs	eightballs
eighteen	eighteen
eighteenfold	eighteenfold
eighteenmo	eighteenmo
eighteenmos	eighteenmos
eighteens	eighteens
eighteenth	eighteenth
eighteenthly	eighteenthly
eighteenths	eighteenths
eightfoil	eightfoil
eightfold	eightfold
eighth	eighth
eighthes	eighthes
eighthly	eighthly
eighths	eighths
eighties	eighties
eightieth	eightieth
eightieths	eightieths
eightish	eightish
eightishly	eightishly
eightling	eightling
eightness	eightness
eightpence	eightpence
eightpenny	eightpenny
eights	eights
eightscore	eightscore
eightsman	eightsman
eightsmen	eightsmen
eightsome	eightsome
eightvo	eightvo
eightvos	eightvos
eighty	eighty
eightyfold	eightyfold
eigi	eigi
eigne	eigne
eignen	eignen
eigner	eigner
eignes	eignes
eihän	eihän
eikae	eikae
eikon	eikon
eikones	eikones
eikonogen	eikonogen
eikonology	eikonology
eikons	eikons
eikä	eikä
eikö	eikö
eila	eila
eiland	eiland
eilanden	eilanden
eild	eild
eile	eile
eileen	eileen
eilen	eilen
eilig	eilig
eilt	eilt
eilte	eilte
eimak	eimak
eimer	eimer
eimeria	eimeria
ein	ein
einander	einander
einar	einar
einbildung	einbildung
einbildungskraft	einbildungskraft
eind	eind
einde	einde
eindelijk	eindelijk
eindelyk	eindelyk
eindruck	eindruck
eine	eine
einem	einem
einen	einen
einer	einer
einerlei	einerlei
eines	eines
einfach	einfach
einfache	einfache
einfachen	einfachen
einfachheit	einfachheit
einfall	einfall
einfluss	einfluss
einfluß	einfluß
eingang	eingang
eingenommen	eingenommen
eingerichtet	eingerichtet
eingeschlossen	eingeschlossen
eingetreten	eingetreten
einheit	einheit
einig	einig
einige	einige
einigen	einigen
einiger	einiger
einiges	einiges
einkanter	einkanter
einkorn	einkorn
einkorns	einkorns
einladung	einladung
einleitung	einleitung
einmal	einmal
einrichtung	einrichtung
eins	eins
einsam	einsam
einsamen	einsamen
einsamkeit	einsamkeit
einsicht	einsicht
einst	einst
einstein	einstein
einsteinian	einsteinian
einsteinium	einsteinium
eintreten	eintreten
eintritt	eintritt
einw	einw
einwohner	einwohner
einzeln	einzeln
einzelne	einzelne
einzelnen	einzelnen
einzelner	einzelner
einzelnheit	einzelnheit
einzig	einzig
einzige	einzige
einzigen	einzigen
einziger	einziger
einziges	einziges
eipä	eipä
eir	eir
eirack	eirack
eire	eire
eireannach	eireannach
eirenarch	eirenarch
eirene	eirene
eirenic	eirenic
eirenicon	eirenicon
eiresione	eiresione
eiry	eiry
eis	eis
eisegeses	eisegeses
eisegesis	eisegesis
eisegetic	eisegetic
eisegetical	eisegetical
eisell	eisell
eisen	eisen
eisenbahn	eisenbahn
eisenberg	eisenberg
eisenhower	eisenhower
eisodic	eisodic
eisoptrophobia	eisoptrophobia
eisteddfod	eisteddfod
eisteddfodau	eisteddfodau
eisteddfodic	eisteddfodic
eisteddfodism	eisteddfodism
eisteddfods	eisteddfods
eiswein	eiswein
eisweins	eisweins
eitelkeit	eitelkeit
either	either
eius	eius
eivät	eivät
eivätkä	eivätkä
elaeis	elaeis
elatedness	elatedness
eleidin	eleidin
elevatedness	elevatedness
ellei	ellei
eloign	eloign
eloigned	eloigned
eloigner	eloigner
eloigners	eloigners
eloigning	eloigning
eloignment	eloignment
eloigns	eloigns
elwood	elwood
embrighten	embrighten
emceeing	emceeing
emceing	emceing
emmeleia	emmeleia
empeine	empeine
empeirema	empeirema
empreinte	empreinte
enamelwork	enamelwork
enamoredness	enamoredness
enamouredness	enamouredness
enceint	enceint
enceinte	enceinte
enceintes	enceintes
encheiria	encheiria
enchytraeid	enchytraeid
enchytraeidae	enchytraeidae
encoignure	encoignure
encoignures	encoignures
endangeitis	endangeitis
endearedness	endearedness
endeictic	endeictic
endeign	endeign
endosteitis	endosteitis
endotracheitis	endotracheitis
eneid	eneid
energeia	energeia
engagedness	engagedness
engjateigur	engjateigur
engleim	engleim
engysseismology	engysseismology
enlargedness	enlargedness
enlighten	enlighten
enlightened	enlightened
enlightenedly	enlightenedly
enlightenedness	enlightenedness
enlightener	enlightener
enlighteners	enlighteners
enlightening	enlightening
enlighteningly	enlighteningly
enlightenment	enlightenment
enlightenments	enlightenments
enlightens	enlightens
enragedness	enragedness
enseigne	enseigne
enseignement	enseignement
ensign	ensign
ensigncies	ensigncies
ensigncy	ensigncy
ensigned	ensigned
ensignhood	ensignhood
ensigning	ensigning
ensignment	ensignment
ensignry	ensignry
ensigns	ensigns
ensignship	ensignship
enslavedness	enslavedness
entangledness	entangledness
enterocleisis	enterocleisis
entitledness	entitledness
entocuneiform	entocuneiform
entscheiden	entscheiden
entscheidung	entscheidung
enveigle	enveigle
enveil	enveil
envermeil	envermeil
epeeist	epeeist
epeeists	epeeists
epeidia	epeidia
epeira	epeira
epeiric	epeiric
epeirid	epeirid
epeiridae	epeiridae
epeirogenesis	epeirogenesis
epeirogenetic	epeirogenetic
epeirogenic	epeirogenic
epeirogenically	epeirogenically
epeirogeny	epeirogeny
epeisodia	epeisodia
epeisodion	epeisodion
ephebeia	ephebeia
ephebeibeia	ephebeibeia
ephebeion	ephebeion
epicheirema	epicheirema
epicheiremata	epicheiremata
epicleidian	epicleidian
epicleidium	epicleidium
epideictic	epideictic
epideictical	epideictical
epideistic	epideistic
epigeic	epigeic
epignathous	epignathous
epigne	epigne
epigoneion	epigoneion
epikeia	epikeia
epilimnetic	epilimnetic
epirotulian	epirotulian
epopoeia	epopoeia
epopoeias	epopoeias
epopoeist	epopoeist
equisignal	equisignal
equulei	equulei
ereignis	ereignis
ereignisse	ereignisse
ergothioneine	ergothioneine
ergreifen	ergreifen
ergreift	ergreift
erinaceidae	erinaceidae
erogeneity	erogeneity
erreichen	erreichen
erreicht	erreicht
erreichte	erreichte
erscheinen	erscheinen
erscheint	erscheint
erscheinung	erscheinung
erscheinungen	erscheinungen
erythraeidae	erythraeidae
erythrolein	erythrolein
erythrophleine	erythrophleine
esloign	esloign
espeire	espeire
essoign	essoign
estrangedness	estrangedness
ethmoturbinal	ethmoturbinal
ethmoturbinate	ethmoturbinate
ethopoeia	ethopoeia
ethoxycaffeine	ethoxycaffeine
ethylhydrocupreine	ethylhydrocupreine
ett'ei	ett'ei
ettei	ettei
etteivät	etteivät
eucleid	eucleid
eucleidae	eucleidae
euploeinae	euploeinae
eupneic	eupneic
eupnoeic	eupnoeic
evenhandedness	evenhandedness
evenmindedness	evenmindedness
eversleigh	eversleigh
ewigkeit	ewigkeit
exaggeratedness	exaggeratedness
exaltedness	exaltedness
excitedness	excitedness
exhaustedness	exhaustedness
expandedness	expandedness
expectedness	expectedness
exposedness	exposedness
extemporaneity	extemporaneity
extendedness	extendedness
extraneity	extraneity
extratheistic	extratheistic
extrovertedness	extrovertedness
eyedness	eyedness
eyednesses	eyednesses
eyeing	eyeing
eyeish	eyeish
fableist	fableist
facsimileing	facsimileing
factotum	factotum
factotums	factotums
fadedness	fadedness
fadednyess	fadednyess
fadein	fadein
fadeins	fadeins
fahrenheit	fahrenheit
faintheartedness	faintheartedness
falseheartedness	falseheartedness
falsiteit	falsiteit
fantaseid	fantaseid
farenheit	farenheit
farfetchedness	farfetchedness
faroeish	faroeish
farseeing	farseeing
farseeingness	farseeingness
farsighted	farsighted
farsightedly	farsightedly
farsightedness	farsightedness
fatheadedness	fatheadedness
favoredness	favoredness
favouredness	favouredness
fazendeiro	fazendeiro
fearedness	fearedness
featherweight	featherweight
featherweights	featherweights
fedn	fedn
feebleheartedness	feebleheartedness
feeblemindedness	feeblemindedness
feeing	feeing
fei	fei
feierlich	feierlich
feif	feif
feigher	feigher
feign	feign
feigned	feigned
feignedly	feignedly
feignedness	feignedness
feigner	feigner
feigners	feigners
feigning	feigning
feigningly	feigningly
feigns	feigns
feijoa	feijoa
feijoas	feijoas
feil	feil
fein	fein
feind	feind
feinde	feinde
feinden	feinden
feindlichen	feindlichen
feine	feine
feinen	feinen
feiner	feiner
feinschmecker	feinschmecker
feinschmeckers	feinschmeckers
feint	feint
feinted	feinted
feinter	feinter
feinting	feinting
feints	feints
feirie	feirie
feis	feis
feiseanna	feiseanna
feist	feist
feistier	feistier
feistiest	feistiest
feistily	feistily
feists	feists
feisty	feisty
feit	feit
fellowheirship	fellowheirship
felwort	felwort
felworts	felworts
femereil	femereil
femineity	femineity
femororotulian	femororotulian
ferreiro	ferreiro
ferrotungsten	ferrotungsten
fettstein	fettstein
fibrotuberculosis	fibrotuberculosis
fichtean	fichtean
fichteanism	fichteanism
fichtelite	fichtelite
fideicommiss	fideicommiss
fideicommissa	fideicommissa
fideicommissaries	fideicommissaries
fideicommissary	fideicommissary
fideicommission	fideicommission
fideicommissioner	fideicommissioner
fideicommissor	fideicommissor
fideicommissum	fideicommissum
fideicommissumissa	fideicommissumissa
fideism	fideism
fideisms	fideisms
fideist	fideist
fideistic	fideistic
fideists	fideists
fighter	fighter
fighteress	fighteress
fighters	fighters
filagreeing	filagreeing
filagreing	filagreing
filigreeing	filigreeing
filigreing	filigreing
fillagreing	fillagreing
fineish	fineish
firefighter	firefighter
firefighters	firefighters
firnismalerei	firnismalerei
fishweir	fishweir
fittedness	fittedness
fixedness	fixedness
flambeing	flambeing
flashtester	flashtester
flatfootedness	flatfootedness
flaughter	flaughter
flavoprotein	flavoprotein
flawedness	flawedness
fleeing	fleeing
fleing	fleing
fleisch	fleisch
fleishig	fleishig
fleyedness	fleyedness
flichter	flichter
flichtered	flichtered
flichtering	flichtering
flichters	flichters
flighted	flighted
flighter	flighter
floodlighted	floodlighted
fluorescein	fluorescein
fluoresceine	fluoresceine
flyweight	flyweight
flyweights	flyweights
foeish	foeish
foolheadedness	foolheadedness
footeite	footeite
forcedness	forcedness
forconceit	forconceit
foreassign	foreassign
foreconceive	foreconceive
foredesign	foredesign
foredesignment	foredesignment
forehandedness	forehandedness
foreign	foreign
foreigneering	foreigneering
foreigner	foreigner
foreigners	foreigners
foreignership	foreignership
foreignism	foreignism
foreignization	foreignization
foreignize	foreignize
foreignly	foreignly
foreignness	foreignness
foreigns	foreigns
foreimagination	foreimagination
foreimagine	foreimagine
foreimpressed	foreimpressed
foreimpression	foreimpression
foreinclined	foreinclined
foreinstruct	foreinstruct
foreintend	foreintend
foreiron	foreiron
forellenstein	forellenstein
foreseeing	foreseeing
foreseeingly	foreseeingly
foreseing	foreseing
foreseize	foreseize
foresighted	foresighted
foresightedly	foresightedly
foresightedness	foresightedness
foresign	foresign
foresignify	foresignify
forethoughted	forethoughted
foreweigh	foreweigh
forfeit	forfeit
forfeitable	forfeitable
forfeitableness	forfeitableness
forfeited	forfeited
forfeiter	forfeiter
forfeiting	forfeiting
forfeits	forfeits
forfeiture	forfeiture
forfeitures	forfeitures
forfouchten	forfouchten
forfoughten	forfoughten
forkedness	forkedness
forleit	forleit
forthtell	forthtell
forthteller	forthteller
fotui	fotui
foughten	foughten
foulmouthedness	foulmouthedness
foveiform	foveiform
fraeulein	fraeulein
framheim	framheim
frankalmoign	frankalmoign
frankalmoigne	frankalmoigne
frankenstein	frankenstein
frankensteins	frankensteins
frankheartedness	frankheartedness
frankreich	frankreich
frankreichs	frankreichs
frappeing	frappeing
fraughted	fraughted
fraulein	fraulein
frauleins	frauleins
frayedness	frayedness
freckledness	freckledness
freehandedness	freehandedness
freeheartedness	freeheartedness
freeing	freeing
freeings	freeings
freeish	freeish
frei	frei
freibergite	freibergite
freiburg	freiburg
freie	freie
freien	freien
freier	freier
freieslebenite	freieslebenite
freiezlebenhe	freiezlebenhe
freight	freight
freightage	freightage
freighted	freighted
freighter	freighter
freighters	freighters
freighting	freighting
freightless	freightless
freightliner	freightliner
freightment	freightment
freights	freights
freightyard	freightyard
freiheit	freiheit
freiherr	freiherr
freijo	freijo
freilich	freilich
freinage	freinage
freir	freir
freit	freit
freith	freith
freity	freity
freiwillig	freiwillig
frenziedness	frenziedness
freundlichkeit	freundlichkeit
fribbleism	fribbleism
fricasseeing	fricasseeing
fricasseing	fricasseing
frieseite	frieseite
frighted	frighted
frighten	frighten
frightenable	frightenable
frightened	frightened
frightenedly	frightenedly
frightenedness	frightenedness
frightener	frightener
frightening	frightening
frighteningly	frighteningly
frighteningness	frighteningness
frightens	frightens
frighter	frighter
frithsoken	frithsoken
frontignac	frontignac
frontignan	frontignan
frothsome	frothsome
fräulein	fräulein
fuchsone	fuchsone
fuddledness	fuddledness
fullword	fullword
fullwords	fullwords
gackeleia	gackeleia
gaeing	gaeing
gageite	gageite
galei	galei
galeid	galeid
galeidae	galeidae
galeiform	galeiform
galilei	galilei
gallein	gallein
galleine	galleine
galleins	galleins
gallinacei	gallinacei
gallwort	gallwort
ganoidei	ganoidei
garnisheeing	garnisheeing
garnisheing	garnisheing
gascoign	gascoign
gascoigny	gascoigny
gaseity	gaseity
gaslighted	gaslighted
gasterosteid	gasterosteid
gasterosteidae	gasterosteidae
gasterosteiform	gasterosteiform
gastrotubotomy	gastrotubotomy
gatehouse	gatehouse
gatehouses	gatehouses
gauleiter	gauleiter
gauteite	gauteite
gawein	gawein
gearbeitet	gearbeitet
geeing	geeing
gegeneinander	gegeneinander
gegenschein	gegenschein
gegenseitig	gegenseitig
gegenteil	gegenteil
geheim	geheim
geheime	geheime
geheimen	geheimen
geheimnis	geheimnis
geheimrat	geheimrat
geic	geic
geiger	geiger
geikia	geikia
geikielite	geikielite
gein	gein
geir	geir
geira	geira
geisa	geisa
geisenheimer	geisenheimer
geisha	geisha
geishas	geishas
geison	geison
geisotherm	geisotherm
geisothermal	geisothermal
geissler	geissler
geissoloma	geissoloma
geissolomataceae	geissolomataceae
geissolomataceous	geissolomataceous
geissorhiza	geissorhiza
geissospermin	geissospermin
geissospermine	geissospermine
geist	geist
geiste	geiste
geister	geister
geistes	geistes
geistige	geistige
geistigen	geistigen
geistlich	geistlich
geistlichen	geistlichen
geitjie	geitjie
geitonogamous	geitonogamous
geitonogamy	geitonogamy
gekleidet	gekleidet
gelegenheid	gelegenheid
gelegenheit	gelegenheit
geleistet	geleistet
geleitet	geleitet
gelignite	gelignite
gemein	gemein
gemeinde	gemeinde
gemeinden	gemeinden
gemeine	gemeine
gemeinen	gemeinen
gemeinsam	gemeinsam
gemeinsamen	gemeinsamen
gemeinschaft	gemeinschaft
gemeinschaften	gemeinschaften
gemeint	gemeint
gemutlichkeit	gemutlichkeit
geneigt	geneigt
genistein	genistein
gentisein	gentisein
gentleheartedness	gentleheartedness
gerechtigkeit	gerechtigkeit
geschrei	geschrei
geschwindigkeit	geschwindigkeit
gesundheit	gesundheit
getreide	getreide
gewissheit	gewissheit
gewißheit	gewißheit
gewohnheit	gewohnheit
gezeigt	gezeigt
gezondheid	gezondheid
gieing	gieing
giftedness	giftedness
gignate	gignate
gignitive	gignitive
gildedness	gildedness
gipseian	gipseian
glabreity	glabreity
glaceing	glaceing
glathsheim	glathsheim
glathsheimr	glathsheimr
gleeishly	gleeishly
gleich	gleich
gleiche	gleiche
gleichem	gleichem
gleichen	gleichen
gleicher	gleicher
gleichfalls	gleichfalls
gleichgueltig	gleichgueltig
gleichgültig	gleichgültig
gleichheit	gleichheit
gleichsam	gleichsam
gleichwohl	gleichwohl
gleichzeitig	gleichzeitig
gleir	gleir
gleit	gleit
gleization	gleization
glotum	glotum
glucoprotein	glucoprotein
glueing	glueing
gluhwein	gluhwein
glutei	glutei
glutetei	glutetei
gluttei	gluttei
glycoproteid	glycoproteid
glycoprotein	glycoprotein
gneiss	gneiss
gneisses	gneisses
gneissic	gneissic
gneissitic	gneissitic
gneissoid	gneissoid
gneissose	gneissose
gneissy	gneissy
gobioidei	gobioidei
goddaughter	goddaughter
goddaughters	goddaughters
godleigh	godleigh
gomeisa	gomeisa
gonorrheic	gonorrheic
gonorrhoeic	gonorrhoeic
goodheartedness	goodheartedness
goodhumoredness	goodhumoredness
goodnaturedness	goodnaturedness
goodtemperedness	goodtemperedness
gorgoneia	gorgoneia
gorgoneion	gorgoneion
gorgoneioneia	gorgoneioneia
gottheit	gottheit
gowkedness	gowkedness
grainedness	grainedness
grand'peine	grand'peine
granddaughter	granddaughter
granddaughterly	granddaughterly
granddaughters	granddaughters
grandeeism	grandeeism
gravenstein	gravenstein
greatheartedness	greatheartedness
greeing	greeing
greif	greif
greifen	greifen
greift	greift
greige	greige
greiges	greiges
greillade	greillade
grein	grein
greing	greing
greis	greis
greisen	greisen
greisens	greisens
greit	greit
greith	greith
grignet	grignet
grillwork	grillwork
groundedness	groundedness
guaneide	guaneide
guaranteeing	guaranteeing
guaranteing	guaranteing
guardedness	guardedness
guignardia	guignardia
guigne	guigne
guignol	guignol
gumshoeing	gumshoeing
gunfighter	gunfighter
gunfighters	gunfighters
gymnetrous	gymnetrous
gymnotus	gymnotus
gypseian	gypseian
habeis	habeis
hackneyedness	hackneyedness
haecceities	haecceities
haecceity	haecceity
haeing	haeing
haematein	haematein
hagein	hagein
haggeis	haggeis
haleine	haleine
halfheartedness	halfheartedness
hallowedness	hallowedness
hameil	hameil
hamperedness	hamperedness
handedness	handedness
handsomeish	handsomeish
hardenedness	hardenedness
hardfistedness	hardfistedness
hardhandedness	hardhandedness
hardheadedness	hardheadedness
hardheartedness	hardheartedness
harebrainedness	harebrainedness
harleian	harleian
hartleian	hartleian
harveian	harveian
hautein	hautein
haveing	haveing
hazelwood	hazelwood
hazelwort	hazelwort
healthsome	healthsome
healthsomely	healthsomely
healthsomeness	healthsomeness
heartedness	heartedness
heatedness	heatedness
heavyhandedness	heavyhandedness
heavyheartedness	heavyheartedness
heavyweight	heavyweight
heavyweights	heavyweights
hecastotheism	hecastotheism
heelwork	heelwork
hei	hei
heiau	heiau
heid	heid
heideck	heideck
heidelberg	heidelberg
heidi	heidi
heidän	heidän
heidät	heidät
heifer	heifer
heiferhood	heiferhood
heifers	heifers
heigh	heigh
heighday	heighday
heigho	heigho
height	height
heighted	heighted
heighten	heighten
heightened	heightened
heightener	heightener
heightening	heightening
heightens	heightens
heighth	heighth
heighths	heighths
heights	heights
heii	heii
heikin	heikin
heikki	heikki
heikum	heikum
heil	heil
heild	heild
heiled	heiled
heilig	heilig
heilige	heilige
heiligen	heiligen
heiling	heiling
heille	heille
heillä	heillä
heils	heils
heiltsuk	heiltsuk
heily	heily
heim	heim
heimat	heimat
heimdal	heimdal
heimin	heimin
heimish	heimish
heimlich	heimlich
hein	hein
heine	heine
heine's	heine's
heinesque	heinesque
heinie	heinie
heinies	heinies
heinous	heinous
heinously	heinously
heinousness	heinousness
heinrich	heinrich
heinsius	heinsius
heintzite	heintzite
heinz	heinz
heir	heir
heiraten	heiraten
heirdom	heirdom
heirdoms	heirdoms
heired	heired
heires	heires
heiress	heiress
heiressdom	heiressdom
heiresses	heiresses
heiresshood	heiresshood
heiring	heiring
heirless	heirless
heirlo	heirlo
heirloom	heirloom
heirlooms	heirlooms
heirs	heirs
heirship	heirship
heirships	heirships
heirskip	heirskip
heishi	heishi
heisse	heisse
heissen	heissen
heisst	heisst
heist	heist
heisted	heisted
heister	heister
heisters	heisters
heisting	heisting
heists	heists
heistä	heistä
heiter	heiter
heiterkeit	heiterkeit
heitiki	heitiki
heitti	heitti
heittää	heittää
heitä	heitä
heize	heize
heized	heized
heizing	heizing
heiß	heiß
heißen	heißen
heißt	heißt
helicoprotein	helicoprotein
helleborein	helleborein
hemaphein	hemaphein
hematein	hematein
hemateins	hemateins
hemignathous	hemignathous
hemileia	hemileia
hemiprotein	hemiprotein
hemoprotein	hemoprotein
heneicosane	heneicosane
henheartedness	henheartedness
henotheism	henotheism
henotheist	henotheist
henotheistic	henotheistic
heracleid	heracleid
heracleidan	heracleidan
herbei	herbei
heredotuberculosis	heredotuberculosis
herein	herein
hereinabove	hereinabove
hereinafter	hereinafter
hereinbefore	hereinbefore
hereinbelow	hereinbelow
hereinto	hereinto
heremeit	heremeit
hermaphrodeity	hermaphrodeity
herotheism	herotheism
herquein	herquein
herrlichkeit	herrlichkeit
heterogeneities	heterogeneities
heterogeneity	heterogeneity
heteronereid	heteronereid
heteronereis	heteronereis
heteroproteide	heteroproteide
hexerei	hexerei
hexereis	hexereis
hieing	hieing
hierbei	hierbei
highhandedness	highhandedness
highheartedness	highheartedness
highlighted	highlighted
highted	highted
hillwoman	hillwoman
hillwort	hillwort
hinein	hinein
hintzeite	hintzeite
hochheimer	hochheimer
hochzeit	hochzeit
hoeing	hoeing
hogtieing	hogtieing
hoheit	hoheit
holbein	holbein
hollowheartedness	hollowheartedness
holoproteide	holoproteide
holostei	holostei
holstein	holstein
holsteins	holsteins
holyokeite	holyokeite
homalonotus	homalonotus
homogeneities	homogeneities
homogeneity	homogeneity
homogeneization	homogeneization
homogeneize	homogeneize
homoseismal	homoseismal
honeyedness	honeyedness
hoodedness	hoodedness
hookedness	hookedness
hopeite	hopeite
hordeiform	hordeiform
hordein	hordein
hordeins	hordeins
hornedness	hornedness
horseier	horseier
horseiest	horseiest
horselaughter	horselaughter
horseshoeing	horseshoeing
hotheadedness	hotheadedness
hotheartedness	hotheartedness
howbeit	howbeit
htel	htel
hulotheism	hulotheism
hulwort	hulwort
hundredweight	hundredweight
hundredweights	hundredweights
hurriedness	hurriedness
hussein	hussein
huxleian	huxleian
hydrocleis	hydrocleis
hydrocupreine	hydrocupreine
hydroturbine	hydroturbine
hygeia	hygeia
hygeian	hygeian
hygeiolatry	hygeiolatry
hygeist	hygeist
hygeistic	hygeistic
hygeists	hygeists
hygieist	hygieist
hygieists	hygieists
hygrodeik	hygrodeik
hygrophaneity	hygrophaneity
hylotheism	hylotheism
hylotheist	hylotheist
hylotheistic	hylotheistic
hylotheistical	hylotheistical
hyperazoturia	hyperazoturia
hyperdeification	hyperdeification
hyperdeified	hyperdeified
hyperdeify	hyperdeify
hyperdeifying	hyperdeifying
hyperpneic	hyperpneic
hypoazoturia	hypoazoturia
hypocleidian	hypocleidian
hypocleidium	hypocleidium
hypogaeic	hypogaeic
hypogeic	hypogeic
hypogeiody	hypogeiody
hypokeimenometry	hypokeimenometry
hypolimnetic	hypolimnetic
hypoproteinemia	hypoproteinemia
hypoproteinosis	hypoproteinosis
hypsophoeia	hypsophoeia
hysterocleisis	hysterocleisis
icosteid	icosteid
icosteidae	icosteidae
icosteine	icosteine
idaein	idaein
ideist	ideist
idoneities	idoneities
idoneity	idoneity
idoteidae	idoteidae
idotheidae	idotheidae
ign	ign
igname	igname
ignaro	ignaro
ignatia	ignatia
ignatian	ignatian
ignatianist	ignatianist
ignatias	ignatias
ignatius	ignatius
ignavia	ignavia
ignaw	ignaw
igneoaqueous	igneoaqueous
igneous	igneous
ignescence	ignescence
ignescent	ignescent
ignicolist	ignicolist
igniferous	igniferous
igniferousness	igniferousness
ignified	ignified
ignifies	ignifies
ignifluous	ignifluous
igniform	igniform
ignifuge	ignifuge
ignify	ignify
ignifying	ignifying
ignigenous	ignigenous
ignipotent	ignipotent
ignipuncture	ignipuncture
ignis	ignis
ignitability	ignitability
ignitable	ignitable
ignite	ignite
ignited	ignited
igniter	igniter
igniters	igniters
ignites	ignites
ignitibility	ignitibility
ignitible	ignitible
igniting	igniting
ignition	ignition
ignitions	ignitions
ignitive	ignitive
ignitor	ignitor
ignitors	ignitors
ignitron	ignitron
ignitrons	ignitrons
ignivomous	ignivomous
ignivomousness	ignivomousness
ignobility	ignobility
ignoble	ignoble
ignobleness	ignobleness
ignoblesse	ignoblesse
ignobly	ignobly
ignominies	ignominies
ignominious	ignominious
ignominiously	ignominiously
ignominiousness	ignominiousness
ignominy	ignominy
ignomious	ignomious
ignorable	ignorable
ignoramus	ignoramus
ignoramuses	ignoramuses
ignorance	ignorance
ignorant	ignorant
ignorantia	ignorantia
ignorantine	ignorantine
ignorantism	ignorantism
ignorantist	ignorantist
ignorantly	ignorantly
ignorantness	ignorantness
ignoration	ignoration
ignore	ignore
ignored	ignored
ignorement	ignorement
ignorer	ignorer
ignorers	ignorers
ignores	ignores
ignoring	ignoring
ignote	ignote
ignotus	ignotus
ihleite	ihleite
ileisa	ileisa
ileitides	ileitides
ileitis	ileitis
illdisposedness	illdisposedness
illeism	illeism
illeist	illeist
illighten	illighten
illimitedness	illimitedness
illmanneredness	illmanneredness
impassionedness	impassionedness
imperceivable	imperceivable
imperceivableness	imperceivableness
imperceivably	imperceivably
imperceived	imperceived
imperceiverant	imperceiverant
impignorate	impignorate
impignorated	impignorated
impignorating	impignorating
impignoration	impignoration
impliedness	impliedness
inbeing	inbeing
inbeings	inbeings
includedness	includedness
incomposedness	incomposedness
inconceivabilities	inconceivabilities
inconceivability	inconceivability
inconceivable	inconceivable
inconceivableness	inconceivableness
inconceivably	inconceivably
inconnectedness	inconnectedness
incorporatedness	incorporatedness
incorporeities	incorporeities
incorporeity	incorporeity
indebtedness	indebtedness
indesignate	indesignate
indigeneity	indigeneity
indigestedness	indigestedness
indign	indign
indignance	indignance
indignancy	indignancy
indignant	indignant
indignantly	indignantly
indignation	indignation
indignatory	indignatory
indignified	indignified
indignify	indignify
indignifying	indignifying
indignities	indignities
indignity	indignity
indignly	indignly
indisposedness	indisposedness
inexpectedness	inexpectedness
infatuatedness	infatuatedness
infectedness	infectedness
infeijdation	infeijdation
infighter	infighter
infighters	infighters
inflamedness	inflamedness
inflatedness	inflatedness
inflectedness	inflectedness
infraprotein	infraprotein
ingrainedness	ingrainedness
inhabitedness	inhabitedness
inhomogeneities	inhomogeneities
inhomogeneity	inhomogeneity
inidoneity	inidoneity
injuredness	injuredness
inlighten	inlighten
inneity	inneity
inrighted	inrighted
inseeing	inseeing
insighted	insighted
insigne	insigne
insignes	insignes
insignia	insignia
insignias	insignias
insignificance	insignificance
insignificancies	insignificancies
insignificancy	insignificancy
insignificant	insignificant
insignificantly	insignificantly
insignificative	insignificative
insignisigne	insignisigne
insignment	insignment
inspreith	inspreith
instantaneity	instantaneity
instructedness	instructedness
inteind	inteind
intendedness	intendedness
interagreeing	interagreeing
interconnectedness	interconnectedness
interestedness	interestedness
interossei	interossei
interreceive	interreceive
interreceived	interreceived
interreceiving	interreceiving
interreign	interreign
interrelatedness	interrelatedness
interrogatedness	interrogatedness
interruptedness	interruptedness
intertieing	intertieing
intervein	intervein
interveinal	interveinal
interveined	interveined
interveining	interveining
interveinous	interveinous
intoxicatedness	intoxicatedness
introvertedness	introvertedness
inuredness	inuredness
inveigh	inveigh
inveighed	inveighed
inveigher	inveigher
inveighing	inveighing
inveighs	inveighs
inveigle	inveigle
inveigled	inveigled
inveiglement	inveiglement
inveigler	inveigler
inveiglers	inveiglers
inveigles	inveigles
inveigling	inveigling
inveil	inveil
invein	invein
involvedness	involvedness
inweight	inweight
iodocasein	iodocasein
iodoprotein	iodoprotein
ipomoein	ipomoein
ipseity	ipseity
irgendein	irgendein
irgendeine	irgendeine
irgendeinem	irgendeinem
iridencleisis	iridencleisis
ironhandedness	ironhandedness
ironheartedness	ironheartedness
isocheim	isocheim
isocheimal	isocheimal
isocheimenal	isocheimenal
isocheimic	isocheimic
isocheimonal	isocheimonal
isocheims	isocheims
isocodeine	isocodeine
isogeneic	isogeneic
isooleic	isooleic
isoseismal	isoseismal
isoseismic	isoseismic
isoseismical	isoseismical
isoseist	isoseist
issei	issei
isseis	isseis
jacklighter	jacklighter
jadedness	jadedness
jadeite	jadeite
jadeites	jadeites
jaggedness	jaggedness
jammedness	jammedness
janeiro	janeiro
jederzeit	jederzeit
jeeing	jeeing
jejunoileitis	jejunoileitis
jelliedness	jelliedness
jenseits	jenseits
jointedness	jointedness
jolterheadedness	jolterheadedness
joseite	joseite
jotunn	jotunn
jotunnheim	jotunnheim
juteinin	juteinin
kadein	kadein
kaikkein	kaikkein
kaleidescope	kaleidescope
kaleidophon	kaleidophon
kaleidophone	kaleidophone
kaleidoscope	kaleidoscope
kaleidoscopes	kaleidoscopes
kaleidoscopic	kaleidoscopic
kaleidoscopical	kaleidoscopical
kaleidoscopically	kaleidoscopically
kamleika	kamleika
kapeika	kapeika
kapellmeister	kapellmeister
kapitein	kapitein
kappellmeister	kappellmeister
karateist	karateist
kathenotheism	kathenotheism
kehoeite	kehoeite
keia	keia
keid	keid
keilhau	keilhau
keilhauite	keilhauite
kein	kein
keine	keine
keinem	keinem
keinen	keinen
keiner	keiner
keines	keines
keineswegs	keineswegs
keir	keir
keiretsu	keiretsu
keirs	keirs
keist	keist
keister	keister
keisters	keisters
keita	keita
keith	keith
keith's	keith's
keitloa	keitloa
keitloas	keitloas
keizer	keizer
kenseikai	kenseikai
kerykeion	kerykeion
kibei	kibei
kibeis	kibeis
killwort	killwort
kinaestheic	kinaestheic
kindheartedness	kindheartedness
kindheit	kindheit
kindredness	kindredness
klarheit	klarheit
kleid	kleid
kleider	kleider
kleidern	kleidern
kleidung	kleidung
kleig	kleig
klein	klein
kleine	kleine
kleinen	kleinen
kleiner	kleiner
kleinere	kleinere
kleines	kleines
kleinian	kleinian
kleinite	kleinite
kleinste	kleinste
kleinsten	kleinsten
kleist	kleist
kleistian	kleistian
klosterheim	klosterheim
klugheit	klugheit
kneeing	kneeing
kneiffia	kneiffia
kneippism	kneippism
knighted	knighted
knightess	knightess
knuckleheadedness	knuckleheadedness
kolbein	kolbein
koreish	koreish
koreishite	koreishite
koschei	koschei
kotschubeite	kotschubeite
kotuku	kotuku
kotukutuku	kotukutuku
krankheit	krankheit
krankheiten	krankheiten
kreil	kreil
kreis	kreis
kreise	kreise
kreisen	kreisen
kreistag	kreistag
kreistle	kreistle
kreitonite	kreitonite
kreittonite	kreittonite
kreitzman	kreitzman
kreivi	kreivi
kuei	kuei
kulturkreis	kulturkreis
l'appareil	l'appareil
l'enceinte	l'enceinte
l'enseignement	l'enseignement
l'oeil	l'oeil
l'oreille	l'oreille
l'orgueil	l'orgueil
laboredness	laboredness
labouredness	labouredness
laceier	laceier
laceiest	laceiest
lackbrainedness	lackbrainedness
lackwittedness	lackwittedness
lactoproteid	lactoproteid
lactoprotein	lactoprotein
laieikawai	laieikawai
lammergeier	lammergeier
lammergeir	lammergeir
lamplighted	lamplighted
lamplighter	lamplighter
landsleit	landsleit
landsmanleit	landsmanleit
langbeinite	langbeinite
lanthanotus	lanthanotus
lapeirousia	lapeirousia
laquei	laquei
lardacein	lardacein
largeheartedness	largeheartedness
laryngotracheitis	laryngotracheitis
lassieish	lassieish
laughsome	laughsome
laughter	laughter
laughterful	laughterful
laughterless	laughterless
laughters	laughters
laurelwood	laurelwood
leadenheartedness	leadenheartedness
learnedness	learnedness
lecideiform	lecideiform
lecideine	lecideine
lecithoprotein	lecithoprotein
leguleian	leguleian
leguleious	leguleious
lei	lei
leib	leib
leibe	leibe
leibnitz	leibnitz
leibnitzian	leibnitzian
leibnitzianism	leibnitzianism
leicester	leicester
leicester's	leicester's
leicestershire	leicestershire
leiche	leiche
leichhardt	leichhardt
leicht	leicht
leichte	leichte
leichten	leichten
leichter	leichter
leid	leid
leiden	leiden
leidenschaft	leidenschaft
leidenschaften	leidenschaften
leider	leider
leidet	leidet
leif	leif
leifite	leifite
leiger	leiger
leigh	leigh
leighton	leighton
leikkiä	leikkiä
leila	leila
leimtype	leimtype
leinster	leinster
leiocephalous	leiocephalous
leiocome	leiocome
leiodermatous	leiodermatous
leiodermia	leiodermia
leiomyofibroma	leiomyofibroma
leiomyoma	leiomyoma
leiomyomas	leiomyomas
leiomyomata	leiomyomata
leiomyomatous	leiomyomatous
leiomyosarcoma	leiomyosarcoma
leiophyllous	leiophyllous
leiophyllum	leiophyllum
leiothrix	leiothrix
leiotrichan	leiotrichan
leiotriches	leiotriches
leiotrichi	leiotrichi
leiotrichidae	leiotrichidae
leiotrichinae	leiotrichinae
leiotrichine	leiotrichine
leiotrichous	leiotrichous
leiotrichy	leiotrichy
leiotropic	leiotropic
leipoa	leipoa
leipsic	leipsic
leipz	leipz
leipzig	leipzig
leipziger	leipziger
leis	leis
leise	leise
leiser	leiser
leishmania	leishmania
leishmanial	leishmanial
leishmaniasis	leishmaniasis
leishmanic	leishmanic
leishmanioid	leishmanioid
leishmaniosis	leishmaniosis
leiss	leiss
leisten	leisten
leister	leister
leistered	leistered
leisterer	leisterer
leistering	leistering
leisters	leisters
leistung	leistung
leisurabe	leisurabe
leisurable	leisurable
leisurably	leisurably
leisure	leisure
leisured	leisured
leisureful	leisureful
leisureless	leisureless
leisureliness	leisureliness
leisurely	leisurely
leisureness	leisureness
leisurer	leisurer
leisures	leisures
leiter	leiter
leith	leith
leitmotif	leitmotif
leitmotifs	leitmotifs
leitmotiv	leitmotiv
leitneria	leitneria
leitneriaceae	leitneriaceae
leitneriaceous	leitneriaceous
leitneriales	leitneriales
leitung	leitung
lengthsome	lengthsome
lengthsomeness	lengthsomeness
lepidoidei	lepidoidei
lepidostei	lepidostei
lepidotus	lepidotus
lepisosteidae	lepisosteidae
lernaeidae	lernaeidae
lernaeiform	lernaeiform
letterweight	letterweight
leuchtenbergite	leuchtenbergite
leveeing	leveeing
levelheadedness	levelheadedness
libytheidae	libytheidae
libytheinae	libytheinae
lichted	lichted
lichtenstein	lichtenstein
liechtenstein	liechtenstein
lighted	lighted
lighten	lighten
lightened	lightened
lightener	lightener
lighteners	lighteners
lightening	lightening
lightens	lightens
lighter	lighter
lighterage	lighterage
lightered	lightered
lighterful	lighterful
lightering	lightering
lighterman	lighterman
lightermen	lightermen
lighters	lighters
lightest	lightest
lightheadedness	lightheadedness
lightheartedness	lightheartedness
lightmindedness	lightmindedness
lightweight	lightweight
lightweights	lightweights
lignaloes	lignaloes
lignatile	lignatile
ligne	ligne
ligneous	ligneous
lignes	lignes
lignescent	lignescent
lignicole	lignicole
lignicoline	lignicoline
lignicolous	lignicolous
ligniferous	ligniferous
lignification	lignification
lignifications	lignifications
lignified	lignified
lignifies	lignifies
ligniform	ligniform
lignify	lignify
lignifying	lignifying
lignin	lignin
lignins	lignins
ligninsulphonate	ligninsulphonate
ligniperdous	ligniperdous
lignite	lignite
lignites	lignites
lignitic	lignitic
lignitiferous	lignitiferous
lignitize	lignitize
lignivorous	lignivorous
lignocaine	lignocaine
lignocellulose	lignocellulose
lignocellulosic	lignocellulosic
lignoceric	lignoceric
lignography	lignography
lignone	lignone
lignose	lignose
lignosity	lignosity
lignosulfonate	lignosulfonate
lignosulphite	lignosulphite
lignosulphonate	lignosulphonate
lignous	lignous
lignum	lignum
lignums	lignums
likemindedness	likemindedness
limelighter	limelighter
limitedness	limitedness
limnetic	limnetic
limnetis	limnetis
lineiform	lineiform
linkedness	linkedness
linnaeite	linnaeite
linoleic	linoleic
linolein	linolein
lionheartedness	lionheartedness
lipoprotein	lipoprotein
listedness	listedness
literalmindedness	literalmindedness
liverheartedness	liverheartedness
liveweight	liveweight
livingstoneite	livingstoneite
llandeilo	llandeilo
loadedness	loadedness
loathsome	loathsome
loathsomely	loathsomely
loathsomeness	loathsomeness
loeil	loeil
loeing	loeing
logeia	logeia
logeion	logeion
logorrheic	logorrheic
lomein	lomein
lomeins	lomeins
longeing	longeing
longheadedness	longheadedness
longsighted	longsighted
longsightedness	longsightedness
lopsidedness	lopsidedness
lorelei	lorelei
lothsome	lothsome
lotuko	lotuko
lotus	lotus
lotuses	lotuses
lotusin	lotusin
lotuslike	lotuslike
loweite	loweite
lugeing	lugeing
lushei	lushei
luteic	luteic
lutein	lutein
luteinization	luteinization
luteinize	luteinize
luteinized	luteinized
luteinizing	luteinizing
luteins	luteins
lwei	lwei
lweis	lweis
lwo	lwo
lwop	lwop
lygaeid	lygaeid
lygaeidae	lygaeidae
lymnaeid	lymnaeid
lymnaeidae	lymnaeidae
lymphangeitis	lymphangeitis
macigno	macigno
macrobiotus	macrobiotus
macrocheilia	macrocheilia
macroseism	macroseism
macroseismic	macroseismic
macroseismograph	macroseismograph
madeira	madeira
madeiran	madeiran
madeiras	madeiras
madeleine	madeleine
maeing	maeing
maffei	maffei
magpieish	magpieish
mailwoman	mailwoman
mailwomen	mailwomen
maimedness	maimedness
makeweight	makeweight
malalignment	malalignment
malconceived	malconceived
malcontentedness	malcontentedness
maleic	maleic
maleinoid	maleinoid
maleinoidal	maleinoidal
malerei	malerei
malign	malign
malignance	malignance
malignancies	malignancies
malignancy	malignancy
malignant	malignant
malignantly	malignantly
malignation	malignation
maligned	maligned
maligner	maligner
maligners	maligners
malignified	malignified
malignify	malignify
malignifying	malignifying
maligning	maligning
malignities	malignities
malignity	malignity
malignly	malignly
malignment	malignment
maligns	maligns
malleableize	malleableize
malleableized	malleableized
malleableizing	malleableizing
mallei	mallei
malleifera	malleifera
malleiferous	malleiferous
malleiform	malleiform
mallein	mallein
malleinization	malleinization
malleinize	malleinize
malloseismic	malloseismic
mallotus	mallotus
malmignatte	malmignatte
mancherlei	mancherlei
mandaeism	mandaeism
mandatedness	mandatedness
manei	manei
mangabeira	mangabeira
manganeisen	manganeisen
mangeier	mangeier
mangeiest	mangeiest
manichaeism	manichaeism
manichaeist	manichaeist
manifestedness	manifestedness
manneredness	manneredness
mannheim	mannheim
mannheimar	mannheimar
mannigfaltigkeit	mannigfaltigkeit
manoeuvreing	manoeuvreing
manslaughter	manslaughter
manslaughterer	manslaughterer
manslaughtering	manslaughtering
manslaughterous	manslaughterous
manslaughters	manslaughters
manysidedness	manysidedness
marbleization	marbleization
marbleize	marbleize
marbleized	marbleized
marbleizer	marbleizer
marbleizes	marbleizes
marbleizing	marbleizing
marinheiro	marinheiro
markedness	markedness
marseillais	marseillais
marseillaise	marseillaise
marseille	marseille
marseilles	marseilles
massedness	massedness
matehood	matehood
mattedness	mattedness
mauvein	mauvein
mauveine	mauveine
maxilloturbinal	maxilloturbinal
mazedness	mazedness
mealworm	mealworm
mealworms	mealworms
mealymouthedness	mealymouthedness
meanspiritedness	meanspiritedness
measledness	measledness
measuredness	measuredness
meekheartedness	meekheartedness
megaseism	megaseism
megaseismic	megaseismic
mehrheit	mehrheit
mei	mei
meibomia	meibomia
meibomian	meibomian
meidän	meidän
meidät	meidät
meigomian	meigomian
meigs	meigs
meiji	meiji
meikle	meikle
meikles	meikles
meile	meile
meilen	meilen
meiler	meiler
meille	meille
meilleur	meilleur
meilleure	meilleure
meilleures	meilleures
meilleurs	meilleurs
meillä	meillä
mein	mein
meindre	meindre
meine	meine
meinem	meinem
meinen	meinen
meiner	meiner
meines	meines
meinie	meinie
meinies	meinies
meinst	meinst
meint	meint
meinte	meinte
meinung	meinung
meiny	meiny
meio	meio
meiobar	meiobar
meiocene	meiocene
meionite	meionite
meiophylly	meiophylly
meioses	meioses
meiosis	meiosis
meiostemonous	meiostemonous
meiotaxy	meiotaxy
meiotic	meiotic
meiotically	meiotically
meisje	meisje
meisjes	meisjes
meissa	meissa
meist	meist
meisten	meisten
meistens	meistens
meister	meister
meisters	meisters
meistersinger	meistersinger
meistä	meistä
meith	meith
meithei	meithei
meitä	meitä
meizoseismal	meizoseismal
meizoseismic	meizoseismic
melilotus	melilotus
melkein	melkein
melopoeia	melopoeia
melopoeic	melopoeic
meltedness	meltedness
melteigite	melteigite
menorrheic	menorrheic
menorrhoeic	menorrhoeic
menschheit	menschheit
menteith	menteith
meritedness	meritedness
merveileux	merveileux
merveille	merveille
merveilles	merveilles
merveilleuse	merveilleuse
merveilleusement	merveilleusement
merveilleux	merveilleux
meseledness	meseledness
mesocuneiform	mesocuneiform
mesonotum	mesonotum
mesoseismal	mesoseismal
messeigneurs	messeigneurs
metageitnion	metageitnion
metaigneous	metaigneous
metalleity	metalleity
metalwork	metalwork
metalworker	metalworker
metalworkers	metalworkers
metalworking	metalworking
metalworks	metalworks
metanotum	metanotum
metaprotein	metaprotein
metropoleis	metropoleis
microcheilia	microcheilia
microcheiria	microcheiria
micronuclei	micronuclei
microseism	microseism
microseismic	microseismic
microseismical	microseismical
microseismicity	microseismicity
microseismograph	microseismograph
microseismology	microseismology
microseismometer	microseismometer
microseismometrograph	microseismometrograph
microseismometry	microseismometry
microtubular	microtubular
microtubule	microtubule
microtus	microtus
middleweight	middleweight
middleweights	middleweights
midvein	midvein
miei	miei
mighted	mighted
migniard	migniard
migniardise	migniardise
migniardize	migniardize
mignon	mignon
mignonette	mignonette
mignonettes	mignonettes
mignonne	mignonne
mignonness	mignonness
mignons	mignons
mildheartedness	mildheartedness
millwork	millwork
millworker	millworker
millworks	millworks
milreis	milreis
miltei	miltei
mimmouthedness	mimmouthedness
mimpei	mimpei
mindedness	mindedness
minseito	minseito
mirthsome	mirthsome
mirthsomeness	mirthsomeness
misadvisedness	misadvisedness
misaligned	misaligned
misalignment	misalignment
misalignments	misalignments
misassign	misassign
misassignment	misassignment
miscellaneity	miscellaneity
misconceit	misconceit
misconceive	misconceive
misconceived	misconceived
misconceiver	misconceiver
misconceives	misconceives
misconceiving	misconceiving
misdesignate	misdesignate
misfeign	misfeign
misguidedness	misguidedness
mislighted	mislighted
misoneism	misoneism
misoneist	misoneist
misoneistic	misoneistic
misotheism	misotheism
misotheist	misotheist
misotheistic	misotheistic
misperceive	misperceive
misperceived	misperceived
misperceiving	misperceiving
misreceive	misreceive
miteinander	miteinander
mitleid	mitleid
mitleiden	mitleiden
mixedness	mixedness
moeglichkeit	moeglichkeit
moeilijk	moeilijk
moeite	moeite
moireing	moireing
moleism	moleism
momentaneity	momentaneity
momotus	momotus
monheimite	monheimite
monocleid	monocleid
monocleide	monocleide
monoeidic	monoeidic
monogeneity	monogeneity
monotheism	monotheism
monotheist	monotheist
monotheistic	monotheistic
monotheistical	monotheistical
monotheistically	monotheistically
monotheists	monotheists
monoureide	monoureide
monroeism	monroeism
monroeist	monroeist
monseigneur	monseigneur
monseignevr	monseignevr
monsignor	monsignor
monsignore	monsignore
monsignori	monsignori
monsignorial	monsignorial
monsignors	monsignors
monteith	monteith
monteiths	monteiths
moonlighted	moonlighted
moonlighter	moonlighter
moonlighters	moonlighters
mopeier	mopeier
mopeiest	mopeiest
mopheadedness	mopheadedness
moreish	moreish
mortifiedness	mortifiedness
mottledness	mottledness
mouseion	mouseion
movieize	movieize
mucoprotein	mucoprotein
muddledness	muddledness
muddleheadedness	muddleheadedness
mullein	mullein
mulleins	mulleins
multeity	multeity
multilighted	multilighted
multitheism	multitheism
multitheist	multitheist
murein	murein
mureins	mureins
museist	museist
mushheadedness	mushheadedness
mussulwoman	mussulwoman
mutedness	mutedness
muttonheadedness	muttonheadedness
mycoprotein	mycoprotein
mydaleine	mydaleine
mylodei	mylodei
mylohyoidei	mylohyoidei
myoproteid	myoproteid
myoprotein	myoprotein
myriotheism	myriotheism
myriotheist	myriotheist
mythopeic	mythopeic
mythopeist	mythopeist
mythopoeia	mythopoeia
mythopoeic	mythopoeic
mythopoeism	mythopoeism
mythopoeist	mythopoeist
myxinoidei	myxinoidei
möglichkeit	möglichkeit
nabijheid	nabijheid
nailwort	nailwort
nakedness	nakedness
narcein	narcein
narceine	narceine
narceines	narceines
narceins	narceins
narrishkeit	narrishkeit
narrowheartedness	narrowheartedness
nasiei	nasiei
nasoturbinal	nasoturbinal
natteredness	natteredness
navelwort	navelwort
nearsighted	nearsighted
nearsightedly	nearsightedly
nearsightedness	nearsightedness
nebeneinander	nebeneinander
necropoleis	necropoleis
needn	needn
neednt	neednt
negatedness	negatedness
neglectedness	neglectedness
nei	nei
neid	neid
neif	neif
neifs	neifs
neige	neige
neiges	neiges
neigh	neigh
neighbor	neighbor
neighbor's	neighbor's
neighbored	neighbored
neighborer	neighborer
neighboress	neighboress
neighborhood	neighborhood
neighborhoods	neighborhoods
neighboring	neighboring
neighborless	neighborless
neighborlike	neighborlike
neighborlikeness	neighborlikeness
neighborliness	neighborliness
neighborly	neighborly
neighbors	neighbors
neighbors'	neighbors'
neighborship	neighborship
neighborstained	neighborstained
neighbour	neighbour
neighbour's	neighbour's
neighboured	neighboured
neighbourer	neighbourer
neighbouress	neighbouress
neighbourhood	neighbourhood
neighbouring	neighbouring
neighbourless	neighbourless
neighbourlike	neighbourlike
neighbourliness	neighbourliness
neighbourly	neighbourly
neighbours	neighbours
neighbours'	neighbours'
neighbourship	neighbourship
neighed	neighed
neigher	neigher
neighing	neighing
neighs	neighs
neigte	neigte
neigung	neigung
neil	neil
neilah	neilah
neill	neill
neillia	neillia
neilson	neilson
nein	nein
neiper	neiper
neisseria	neisseria
neisserieae	neisserieae
neist	neist
neither	neither
neiti	neiti
neito	neito
neoteinia	neoteinia
neoteinic	neoteinic
nephrotuberculosis	nephrotuberculosis
nereid	nereid
nereidae	nereidae
nereidean	nereidean
nereides	nereides
nereidiform	nereidiform
nereidiformia	nereidiformia
nereidous	nereidous
nereids	nereids
nereis	nereis
nereite	nereite
netheist	netheist
newfangledness	newfangledness
niceish	niceish
niersteiner	niersteiner
nietzscheism	nietzscheism
niflheim	niflheim
nighted	nighted
nighter	nighter
nighters	nighters
nightertale	nightertale
nightery	nightery
nignay	nignay
nignye	nignye
nisei	nisei
niseis	niseis
nobleheartedness	nobleheartedness
nolleity	nolleity
nomeidae	nomeidae
nomineeism	nomineeism
nomotheism	nomotheism
nonabstractedness	nonabstractedness
nonalignable	nonalignable
nonaligned	nonaligned
nonalignment	nonalignment
nonamazedness	nonamazedness
nonarraignment	nonarraignment
nonassignability	nonassignability
nonassignabilty	nonassignabilty
nonassignable	nonassignable
nonassignably	nonassignably
nonassigned	nonassigned
nonassignment	nonassignment
nonatheistic	nonatheistic
nonatheistical	nonatheistical
nonatheistically	nonatheistically
nonbeing	nonbeing
nonbeings	nonbeings
noncaffeine	noncaffeine
noncaffeinic	noncaffeinic
noncleistogamic	noncleistogamic
noncleistogamous	noncleistogamous
nonconceiving	nonconceiving
nonconsignment	nonconsignment
noncounterfeit	noncounterfeit
nondeceit	nondeceit
nondeceivable	nondeceivable
nondeceiving	nondeceiving
nondeist	nondeist
nondeistic	nondeistic
nondeistical	nondeistical
nondeistically	nondeistically
nondesignate	nondesignate
nondesignative	nondesignative
nondesigned	nondesigned
nondissipatedness	nondissipatedness
nondistortedness	nondistortedness
noneidetic	noneidetic
nonenlightened	nonenlightened
nonenlightening	nonenlightening
nonfighter	nonfighter
nonforeign	nonforeign
nonforeigness	nonforeigness
nonforeignness	nonforeignness
nonforfeitable	nonforfeitable
nonforfeiting	nonforfeiting
nonforfeiture	nonforfeiture
nonforfeitures	nonforfeitures
nonheinous	nonheinous
nonheinously	nonheinously
nonheinousness	nonheinousness
nonhomogeneity	nonhomogeneity
nonigneous	nonigneous
nonignitability	nonignitability
nonignitable	nonignitable
nonignitibility	nonignitibility
nonignitible	nonignitible
nonignominious	nonignominious
nonignominiously	nonignominiously
nonignominiousness	nonignominiousness
nonignorant	nonignorant
nonignorantly	nonignorantly
noninterruptedness	noninterruptedness
nonintrovertedness	nonintrovertedness
nonmalignance	nonmalignance
nonmalignancy	nonmalignancy
nonmalignant	nonmalignant
nonmalignantly	nonmalignantly
nonmalignity	nonmalignity
nonmonotheistic	nonmonotheistic
nonopinionatedness	nonopinionatedness
nonpantheistic	nonpantheistic
nonpantheistical	nonpantheistical
nonpantheistically	nonpantheistically
nonpareil	nonpareil
nonpareils	nonpareils
nonperceivable	nonperceivable
nonperceivably	nonperceivably
nonperceiving	nonperceiving
nonpreparedness	nonpreparedness
nonproteid	nonproteid
nonprotein	nonprotein
nonproteinaceous	nonproteinaceous
nonprotuberance	nonprotuberance
nonprotuberancies	nonprotuberancies
nonprotuberancy	nonprotuberancy
nonprotuberant	nonprotuberant
nonprotuberantly	nonprotuberantly
nonreceipt	nonreceipt
nonreceivable	nonreceivable
nonreceiving	nonreceiving
nonreigning	nonreigning
nonreimbursement	nonreimbursement
nonreinforcement	nonreinforcement
nonreinstatement	nonreinstatement
nonresignation	nonresignation
nonsacredness	nonsacredness
nonsecludedness	nonsecludedness
nonseismic	nonseismic
nonseizure	nonseizure
nonsignable	nonsignable
nonsignatories	nonsignatories
nonsignatory	nonsignatory
nonsignature	nonsignature
nonsignificance	nonsignificance
nonsignificancy	nonsignificancy
nonsignificant	nonsignificant
nonsignificantly	nonsignificantly
nonsignification	nonsignification
nonsignificative	nonsignificative
nonsovereign	nonsovereign
nonsovereignly	nonsovereignly
nonspiritedness	nonspiritedness
nontheistic	nontheistic
nontheistical	nontheistical
nontheistically	nontheistically
noodleism	noodleism
notedness	notedness
notehead	notehead
noteholder	noteholder
nothwendigkeit	nothwendigkeit
notogaeic	notogaeic
notum	notum
notungulata	notungulata
notungulate	notungulate
notus	notus
notwendigkeit	notwendigkeit
noumeite	noumeite
nucleclei	nucleclei
nuclei	nuclei
nucleic	nucleic
nucleiferous	nucleiferous
nucleiform	nucleiform
nuclein	nuclein
nucleinase	nucleinase
nucleins	nucleins
nucleization	nucleization
nucleize	nucleize
nucleoprotein	nucleoprotein
numbedness	numbedness
numskulledness	numskulledness
o'neil	o'neil
o'neill	o'neill
o'reilly	o'reilly
obeir	obeir
obeisance	obeisance
obeisances	obeisances
obeisant	obeisant
obeisantly	obeisantly
obeish	obeish
obeism	obeism
obgleich	obgleich
obligedness	obligedness
obrotund	obrotund
obsign	obsign
obsignate	obsignate
obsignation	obsignation
obsignatory	obsignatory
ochreish	ochreish
odalwoman	odalwoman
oeil	oeil
oeillade	oeillade
oeillades	oeillades
oeillet	oeillet
oesterreich	oesterreich
offendedness	offendedness
offhandedness	offhandedness
ogreish	ogreish
ogreishly	ogreishly
ogreism	ogreism
ogreisms	ogreisms
oheim	oheim
oikein	oikein
oldfangledness	oldfangledness
oleic	oleic
oleiferous	oleiferous
olein	olein
oleine	oleine
oleines	oleines
oleins	oleins
olympieion	olympieion
omneity	omneity
omnisignificance	omnisignificance
omnisignificant	omnisignificant
onderscheiden	onderscheiden
oneida	oneida
oneidas	oneidas
oneill	oneill
oneiric	oneiric
oneirocrit	oneirocrit
oneirocritic	oneirocritic
oneirocritical	oneirocritical
oneirocritically	oneirocritically
oneirocriticism	oneirocriticism
oneirocritics	oneirocritics
oneirodynia	oneirodynia
oneirologist	oneirologist
oneirology	oneirology
oneiromancer	oneiromancer
oneiromancy	oneiromancy
oneiroscopic	oneiroscopic
oneiroscopist	oneiroscopist
oneiroscopy	oneiroscopy
oneirotic	oneirotic
oneism	oneism
onesigned	onesigned
onomatopoeia	onomatopoeia
onomatopoeial	onomatopoeial
onomatopoeian	onomatopoeian
onomatopoeic	onomatopoeic
onomatopoeical	onomatopoeical
onomatopoeically	onomatopoeically
opeidoscope	opeidoscope
openendedness	openendedness
openhandedness	openhandedness
openheartedness	openheartedness
openmouthedness	openmouthedness
ophicleide	ophicleide
ophicleidean	ophicleidean
ophicleidist	ophicleidist
opinionatedness	opinionatedness
opinionedness	opinionedness
opisthoporeia	opisthoporeia
oppenheim	oppenheim
oppignerate	oppignerate
oppignorate	oppignorate
orangeish	orangeish
orangeism	orangeism
orangeist	orangeist
orcein	orcein
orceins	orceins
orcheitis	orcheitis
orderedness	orderedness
oreide	oreide
oreides	oreides
oreilet	oreilet
oreille	oreille
oreiller	oreiller
oreilles	oreilles
oreillet	oreillet
oreillette	oreillette
oresteia	oresteia
orgueil	orgueil
orgueilleux	orgueilleux
orignal	orignal
orotund	orotund
orotundity	orotundity
orotunds	orotunds
orpheist	orpheist
orseille	orseille
orseilline	orseilline
orthogneiss	orthogneiss
orthopneic	orthopneic
orthopnoeic	orthopnoeic
ortstein	ortstein
oscheitis	oscheitis
ossein	ossein
osseins	osseins
osteichthyes	osteichthyes
ostein	ostein
osteitic	osteitic
osteitides	osteitides
osteitis	osteitis
ostreicultural	ostreicultural
ostreiculture	ostreiculture
ostreiculturist	ostreiculturist
ostreidae	ostreidae
ostreiform	ostreiform
otaheitan	otaheitan
otaheite	otaheite
otocleisis	otocleisis
ottweilian	ottweilian
otuquian	otuquian
oturia	oturia
otus	otus
oughted	oughted
outdatedness	outdatedness
outfighter	outfighter
outfleeing	outfleeing
outlighten	outlighten
outreign	outreign
outseeing	outseeing
outsidedness	outsidedness
outweigh	outweigh
outweighed	outweighed
outweighing	outweighing
outweighs	outweighs
outweight	outweight
ovariotubal	ovariotubal
ovatorotundate	ovatorotundate
overassuredness	overassuredness
overbigness	overbigness
overblessedness	overblessedness
overcontentedness	overcontentedness
overcrowdedness	overcrowdedness
overdelighted	overdelighted
overdelightedly	overdelightedly
overdevotedness	overdevotedness
overdignified	overdignified
overdignifiedly	overdignifiedly
overdignifiedness	overdignifiedness
overdignify	overdignify
overdignifying	overdignifying
overdignity	overdignity
overdyeing	overdyeing
overexertedness	overexertedness
overfreight	overfreight
overfreighted	overfreighted
overfrighted	overfrighted
overfrighten	overfrighten
overheight	overheight
overheighten	overheighten
overheinous	overheinous
overinterestedness	overinterestedness
overlearnedness	overlearnedness
overleisured	overleisured
overlighted	overlighted
overnighter	overnighter
overnighters	overnighters
overreservedness	overreservedness
overrighteous	overrighteous
overrighteously	overrighteously
overrighteousness	overrighteousness
overseeing	overseeing
overseing	overseing
oversigned	oversigned
overstraighten	overstraighten
overtiredness	overtiredness
overveil	overveil
overweigh	overweigh
overweighed	overweighed
overweighing	overweighing
overweighs	overweighs
overweight	overweight
overweightage	overweightage
overweighted	overweighted
overweighting	overweighting
owyheeite	owyheeite
oxreim	oxreim
paaneleinrg	paaneleinrg
paelignian	paelignian
paideia	paideia
paintedness	paintedness
pairedness	pairedness
palaeic	palaeic
palaeichthyan	palaeichthyan
palaeichthyes	palaeichthyes
palaeichthyic	palaeichthyic
palamedeidae	palamedeidae
paledness	paledness
paleichthyologic	paleichthyologic
paleichthyologist	paleichthyologist
paleichthyology	paleichthyology
paleiform	paleiform
paleis	paleis
palmitoleic	palmitoleic
palmiveined	palmiveined
pamperedness	pamperedness
panaceist	panaceist
paneity	paneity
panelwork	panelwork
panentheism	panentheism
panosteitis	panosteitis
pantheian	pantheian
pantheic	pantheic
pantheism	pantheism
pantheist	pantheist
pantheistic	pantheistic
pantheistical	pantheistical
pantheistically	pantheistically
pantheists	pantheists
paperweight	paperweight
paperweights	paperweights
pappenheim	pappenheim
pappenheimer	pappenheimer
parabotulism	parabotulism
paracasein	paracasein
paracaseinate	paracaseinate
paradiseidae	paradiseidae
paradiseinae	paradiseinae
paragneiss	paragneiss
parahopeite	parahopeite
paraleipsis	paraleipsis
paranuclei	paranuclei
paranucleic	paranucleic
paranuclein	paranuclein
paranucleinic	paranucleinic
paraprotein	paraprotein
parchedness	parchedness
pareiasauri	pareiasauri
pareiasauria	pareiasauria
pareiasaurian	pareiasaurian
pareiasaurus	pareiasaurus
pareil	pareil
pareille	pareille
pareilles	pareilles
pareils	pareils
pareioplitae	pareioplitae
pareira	pareira
pareiras	pareiras
parosteitis	parosteitis
parseeism	parseeism
partedness	partedness
partei	partei
parteien	parteien
pastedness	pastedness
patashte	patashte
pathopoeia	pathopoeia
patrolwoman	patrolwoman
patrolwomen	patrolwomen
peakedness	peakedness
pearceite	pearceite
pearlwort	pearlwort
peeing	peeing
peeledness	peeledness
peevedness	peevedness
peignoir	peignoir
peignoirs	peignoirs
peiktha	peiktha
pein	pein
peindre	peindre
peine	peine
peined	peined
peines	peines
peining	peining
peins	peins
peint	peint
peinte	peinte
peintre	peintre
peintres	peintres
peinture	peinture
peintures	peintures
peiping	peiping
peirameter	peirameter
peirastic	peirastic
peirastically	peirastically
peirce	peirce
peisage	peisage
peisant	peisant
peise	peise
peised	peised
peiser	peiser
peises	peises
peising	peising
peitho	peitho
peitrel	peitrel
peixere	peixere
peixerey	peixerey
peize	peize
pencilwood	pencilwood
peneid	peneid
peneseismic	peneseismic
penniveined	penniveined
pennyweight	pennyweight
pennyweights	pennyweights
penroseite	penroseite
peopleize	peopleize
perceiue	perceiue
perceivability	perceivability
perceivable	perceivable
perceivableness	perceivableness
perceivably	perceivably
perceivance	perceivance
perceivancy	perceivancy
perceive	perceive
perceived	perceived
perceivedly	perceivedly
perceivedness	perceivedness
perceiver	perceiver
perceivers	perceivers
perceives	perceives
perceiving	perceiving
perceivingness	perceivingness
pereia	pereia
pereion	pereion
pereions	pereions
pereiopod	pereiopod
pereira	pereira
pereirine	pereirine
perignathic	perignathic
periosteitis	periosteitis
peripeteia	peripeteia
perjuredness	perjuredness
peronei	peronei
peronnei	peronnei
perplexedness	perplexedness
perqueir	perqueir
perreia	perreia
perseid	perseid
perseite	perseite
perseitol	perseitol
perseity	perseity
personeity	personeity
persuadedness	persuadedness
persönlichkeit	persönlichkeit
perturbedness	perturbedness
pervertedness	pervertedness
petreity	petreity
pettedness	pettedness
pfeifferella	pfeifferella
pfeil	pfeil
phaeism	phaeism
phariseeism	phariseeism
pharmacopeia	pharmacopeia
pharmacopeial	pharmacopeial
pharmacopeian	pharmacopeian
pharmacopeias	pharmacopeias
pharmacopoeia	pharmacopoeia
pharmacopoeial	pharmacopoeial
pharmacopoeian	pharmacopoeian
pharmacopoeias	pharmacopoeias
pharmacopoeic	pharmacopoeic
pharmacopoeist	pharmacopoeist
pheidole	pheidole
phenolphthalein	phenolphthalein
phenolsulphonephthalein	phenolsulphonephthalein
phersephoneia	phersephoneia
philoneism	philoneism
philoprogeneity	philoprogeneity
philotheism	philotheism
philotheist	philotheist
philotheistic	philotheistic
phoneidoscope	phoneidoscope
phoneidoscopic	phoneidoscopic
phoneier	phoneier
phoneiest	phoneiest
phonodeik	phonodeik
phosphoglycoprotein	phosphoglycoprotein
phosphoprotein	phosphoprotein
phosphotungstate	phosphotungstate
phosphotungstic	phosphotungstic
phototransceiver	phototransceiver
phototube	phototube
photuria	photuria
phryganeid	phryganeid
phryganeidae	phryganeidae
phthalein	phthalein
phthaleine	phthaleine
phthaleinometer	phthaleinometer
phycophaein	phycophaein
physitheism	physitheism
physitheist	physitheist
physitheistic	physitheistic
picein	picein
pickedness	pickedness
piedness	piedness
pieing	pieing
pigeonheartedness	pigeonheartedness
pigheadedness	pigheadedness
pightel	pightel
pignet	pignet
pignolia	pignolia
pignon	pignon
pignora	pignora
pignorate	pignorate
pignorated	pignorated
pignoration	pignoration
pignoratitious	pignoratitious
pignorative	pignorative
pignus	pignus
pignut	pignut
pignuts	pignuts
pilei	pilei
pileiform	pileiform
pilledness	pilledness
pillworm	pillworm
pillwort	pillwort
pinchedness	pinchedness
pinheadedness	pinheadedness
piperideine	piperideine
piteira	piteira
pithsome	pithsome
pitiedness	pitiedness
pixieish	pixieish
placoganoidei	placoganoidei
placoidei	placoidei
plancheite	plancheite
planorotund	planorotund
plastein	plastein
plataleidae	plataleidae
plataleiform	plataleiform
plataleinae	plataleinae
plataleine	plataleine
plateholder	plateholder
plateiasmus	plateiasmus
platycheiria	platycheiria
playwrightess	playwrightess
pleasedness	pleasedness
plebeian	plebeian
plebeiance	plebeiance
plebeianisation	plebeianisation
plebeianise	plebeianise
plebeianised	plebeianised
plebeianising	plebeianising
plebeianism	plebeianism
plebeianization	plebeianization
plebeianize	plebeianize
plebeianized	plebeianized
plebeianizing	plebeianizing
plebeianly	plebeianly
plebeianness	plebeianness
plebeians	plebeians
plebeity	plebeity
plecotus	plecotus
pleiad	pleiad
pleiades	pleiades
pleiads	pleiads
pleinairism	pleinairism
pleinairist	pleinairist
pleine	pleine
pleinement	pleinement
pleines	pleines
pleins	pleins
pleiobar	pleiobar
pleiocene	pleiocene
pleiochromia	pleiochromia
pleiochromic	pleiochromic
pleiomastia	pleiomastia
pleiomazia	pleiomazia
pleiomerous	pleiomerous
pleiomery	pleiomery
pleion	pleion
pleione	pleione
pleionian	pleionian
pleiophyllous	pleiophyllous
pleiophylly	pleiophylly
pleiotaxis	pleiotaxis
pleiotaxy	pleiotaxy
pleiotropic	pleiotropic
pleiotropically	pleiotropically
pleiotropism	pleiotropism
pleiotropy	pleiotropy
pleis	pleis
pleistocene	pleistocene
pleistocenic	pleistocenic
pleistoseist	pleistoseist
pleurotus	pleurotus
plighted	plighted
plighter	plighter
plighters	plighters
ploceidae	ploceidae
ploceiform	ploceiform
ploceinae	ploceinae
plouteneion	plouteneion
pluckedness	pluckedness
plutei	plutei
pluteiform	pluteiform
pluteutei	pluteutei
pococuranteism	pococuranteism
poignado	poignado
poignance	poignance
poignancies	poignancies
poignancy	poignancy
poignant	poignant
poignantly	poignantly
poignard	poignard
poignet	poignet
pointedness	pointedness
poleis	poleis
polionotus	polionotus
polishedness	polishedness
politei	politei
politeia	politeia
polizei	polizei
pollutedness	pollutedness
poltergeist	poltergeist
poltergeistism	poltergeistism
poltergeists	poltergeists
polyeidic	polyeidic
polyeidism	polyeidism
polyideic	polyideic
polyideism	polyideism
polymignite	polymignite
polypneic	polypneic
polypnoeic	polypnoeic
polysemeia	polysemeia
polysidedness	polysidedness
polytheism	polytheism
polytheist	polytheist
polytheistic	polytheistic
polytheistical	polytheistical
polytheistically	polytheistically
polytheists	polytheists
polytheize	polytheize
pompeian	pompeian
pompeii	pompeii
pompeius	pompeius
poodleish	poodleish
poolwort	poolwort
popeism	popeism
poplitei	poplitei
poseidon	poseidon
poseidonian	poseidonian
possessedness	possessedness
postdisseizin	postdisseizin
postdisseizor	postdisseizor
postgonorrheic	postgonorrheic
postmeiotic	postmeiotic
postnotum	postnotum
postnotums	postnotums
postnotumta	postnotumta
postsign	postsign
postsigner	postsigner
potus	potus
practicedness	practicedness
preagreeing	preagreeing
preassign	preassign
preassigned	preassigned
preassigning	preassigning
preassigns	preassigns
precampaign	precampaign
precednce	precednce
preconceivable	preconceivable
preconceive	preconceive
preconceived	preconceived
preconceives	preconceives
preconceiving	preconceiving
preconcertedness	preconcertedness
preconfinemnt	preconfinemnt
preconsign	preconsign
precontemporaneity	precontemporaneity
predeceive	predeceive
predeceived	predeceived
predeceiver	predeceiver
predeceiving	predeceiving
predecreeing	predecreeing
predeication	predeication
predesign	predesign
predesignate	predesignate
predesignated	predesignated
predesignates	predesignates
predesignating	predesignating
predesignation	predesignation
predesignatory	predesignatory
predisagreeing	predisagreeing
predisposedness	predisposedness
prednisolone	prednisolone
prednisone	prednisone
preeing	preeing
preenlighten	preenlighten
preenlightener	preenlightener
preenlightenment	preenlightenment
preferredness	preferredness
prefrighten	prefrighten
preguaranteeing	preguaranteeing
preidea	preidea
preidentification	preidentification
preidentified	preidentified
preidentify	preidentify
preidentifying	preidentifying
preignition	preignition
preilium	preilium
preilluminate	preilluminate
preillumination	preillumination
preillustrate	preillustrate
preillustrated	preillustrated
preillustrating	preillustrating
preillustration	preillustration
preimage	preimage
preimaginary	preimaginary
preimagination	preimagination
preimagine	preimagine
preimagined	preimagined
preimagining	preimagining
preimbibe	preimbibe
preimbibed	preimbibed
preimbibing	preimbibing
preimbue	preimbue
preimbued	preimbued
preimbuing	preimbuing
preimitate	preimitate
preimitated	preimitated
preimitating	preimitating
preimitation	preimitation
preimitative	preimitative
preimmigration	preimmigration
preimpair	preimpair
preimpairment	preimpairment
preimpart	preimpart
preimperial	preimperial
preimport	preimport
preimportance	preimportance
preimportant	preimportant
preimportantly	preimportantly
preimportation	preimportation
preimposal	preimposal
preimpose	preimpose
preimposed	preimposed
preimposing	preimposing
preimposition	preimposition
preimpress	preimpress
preimpression	preimpression
preimpressionism	preimpressionism
preimpressionist	preimpressionist
preimpressive	preimpressive
preimprove	preimprove
preimproved	preimproved
preimprovement	preimprovement
preimproving	preimproving
preinaugural	preinaugural
preinaugurate	preinaugurate
preinaugurated	preinaugurated
preinaugurating	preinaugurating
preincarnate	preincarnate
preincentive	preincentive
preincination	preincination
preinclination	preinclination
preincline	preincline
preinclined	preinclined
preinclining	preinclining
preinclude	preinclude
preincluded	preincluded
preincluding	preincluding
preinclusion	preinclusion
preincorporate	preincorporate
preincorporated	preincorporated
preincorporating	preincorporating
preincorporation	preincorporation
preincrease	preincrease
preincreased	preincreased
preincreasing	preincreasing
preindebted	preindebted
preindebtedly	preindebtedly
preindebtedness	preindebtedness
preindemnification	preindemnification
preindemnified	preindemnified
preindemnify	preindemnify
preindemnifying	preindemnifying
preindemnity	preindemnity
preindependence	preindependence
preindependent	preindependent
preindependently	preindependently
preindesignate	preindesignate
preindicant	preindicant
preindicate	preindicate
preindicated	preindicated
preindicating	preindicating
preindication	preindication
preindicative	preindicative
preindispose	preindispose
preindisposed	preindisposed
preindisposing	preindisposing
preindisposition	preindisposition
preinduce	preinduce
preinduced	preinduced
preinducement	preinducement
preinducing	preinducing
preinduction	preinduction
preinductive	preinductive
preindulge	preindulge
preindulged	preindulged
preindulgence	preindulgence
preindulgent	preindulgent
preindulging	preindulging
preindustrial	preindustrial
preindustry	preindustry
preinfect	preinfect
preinfection	preinfection
preinfer	preinfer
preinference	preinference
preinferredpreinferring	preinferredpreinferring
preinflection	preinflection
preinflectional	preinflectional
preinflict	preinflict
preinfliction	preinfliction
preinfluence	preinfluence
preinform	preinform
preinformation	preinformation
preinhabit	preinhabit
preinhabitant	preinhabitant
preinhabitation	preinhabitation
preinhere	preinhere
preinhered	preinhered
preinhering	preinhering
preinherit	preinherit
preinheritance	preinheritance
preinitial	preinitial
preinitialize	preinitialize
preinitialized	preinitialized
preinitializes	preinitializes
preinitializing	preinitializing
preinitiate	preinitiate
preinitiated	preinitiated
preinitiating	preinitiating
preinitiation	preinitiation
preinjure	preinjure
preinjurious	preinjurious
preinjury	preinjury
preinquisition	preinquisition
preinscribe	preinscribe
preinscribed	preinscribed
preinscribing	preinscribing
preinscription	preinscription
preinsert	preinsert
preinserted	preinserted
preinserting	preinserting
preinsertion	preinsertion
preinserts	preinserts
preinsinuate	preinsinuate
preinsinuated	preinsinuated
preinsinuating	preinsinuating
preinsinuatingly	preinsinuatingly
preinsinuation	preinsinuation
preinsinuative	preinsinuative
preinspect	preinspect
preinspection	preinspection
preinspector	preinspector
preinspire	preinspire
preinspired	preinspired
preinspiring	preinspiring
preinstall	preinstall
preinstallation	preinstallation
preinstill	preinstill
preinstillation	preinstillation
preinstruct	preinstruct
preinstructed	preinstructed
preinstructing	preinstructing
preinstruction	preinstruction
preinstructional	preinstructional
preinstructive	preinstructive
preinstructs	preinstructs
preinsula	preinsula
preinsular	preinsular
preinsulate	preinsulate
preinsulated	preinsulated
preinsulating	preinsulating
preinsulation	preinsulation
preinsult	preinsult
preinsurance	preinsurance
preinsure	preinsure
preinsured	preinsured
preinsuring	preinsuring
preintellectual	preintellectual
preintellectually	preintellectually
preintelligence	preintelligence
preintelligent	preintelligent
preintelligently	preintelligently
preintend	preintend
preintention	preintention
preintercede	preintercede
preinterceded	preinterceded
preinterceding	preinterceding
preintercession	preintercession
preinterchange	preinterchange
preintercourse	preintercourse
preinterest	preinterest
preinterfere	preinterfere
preinterference	preinterference
preinterpret	preinterpret
preinterpretation	preinterpretation
preinterpretative	preinterpretative
preinterrupt	preinterrupt
preinterview	preinterview
preintimate	preintimate
preintimated	preintimated
preintimately	preintimately
preintimating	preintimating
preintimation	preintimation
preintone	preintone
preinvasive	preinvasive
preinvent	preinvent
preinvention	preinvention
preinventive	preinventive
preinventories	preinventories
preinventory	preinventory
preinvest	preinvest
preinvestigate	preinvestigate
preinvestigated	preinvestigated
preinvestigating	preinvestigating
preinvestigation	preinvestigation
preinvestigator	preinvestigator
preinvestment	preinvestment
preinvitation	preinvitation
preinvite	preinvite
preinvited	preinvited
preinviting	preinviting
preinvocation	preinvocation
preinvolve	preinvolve
preinvolved	preinvolved
preinvolvement	preinvolvement
preinvolving	preinvolving
preiotization	preiotization
preiotize	preiotize
preirrigation	preirrigation
preirrigational	preirrigational
preis	preis
preise	preise
preissuance	preissuance
preissue	preissue
preissued	preissued
preissuing	preissuing
prelatehood	prelatehood
prelateity	prelateity
premalignant	premalignant
premeditatedness	premeditatedness
premeiotic	premeiotic
preoccupiedness	preoccupiedness
preparedness	preparedness
preperceive	preperceive
prereceipt	prereceipt
prereceive	prereceive
prereceived	prereceived
prereceiver	prereceiver
prereceiving	prereceiving
prerighteous	prerighteous
prerighteously	prerighteously
prerighteousness	prerighteousness
preseeing	preseeing
presign	presign
presignal	presignal
presignaled	presignaled
presignificance	presignificance
presignificancy	presignificancy
presignificant	presignificant
presignification	presignification
presignificative	presignificative
presignificator	presignificator
presignified	presignified
presignify	presignify
presignifying	presignifying
prespontaneity	prespontaneity
prestraighten	prestraighten
preweigh	preweigh
priceite	priceite
princeite	princeite
prizefighter	prizefighter
prizefighters	prizefighters
proatheism	proatheism
proatheist	proatheist
proatheistic	proatheistic
prochein	prochein
proclei	proclei
proforeign	proforeign
proheim	proheim
prokeimenon	prokeimenon
pronotum	pronotum
pronouncedness	pronouncedness
pronuclei	pronuclei
proresignation	proresignation
proseity	proseity
prosopopoeia	prosopopoeia
prosopopoeial	prosopopoeial
protei	protei
proteic	proteic
proteid	proteid
proteida	proteida
proteidae	proteidae
proteide	proteide
proteidean	proteidean
proteides	proteides
proteidogenous	proteidogenous
proteids	proteids
proteiform	proteiform
protein	protein
proteinaceous	proteinaceous
proteinase	proteinase
proteinate	proteinate
proteinic	proteinic
proteinochromogen	proteinochromogen
proteinous	proteinous
proteinphobia	proteinphobia
proteins	proteins
proteinuria	proteinuria
proteinuric	proteinuric
protractedness	protractedness
protuberance	protuberance
protuberances	protuberances
protuberancies	protuberancies
protuberancy	protuberancy
protuberant	protuberant
protuberantial	protuberantial
protuberantly	protuberantly
protuberantness	protuberantness
protuberate	protuberate
protuberated	protuberated
protuberating	protuberating
protuberosity	protuberosity
protuberous	protuberous
protura	protura
proturan	proturan
protutor	protutor
protutory	protutory
pseudonuclein	pseudonuclein
pseudotubercular	pseudotubercular
pseudotuberculosis	pseudotuberculosis
pseudotuberculous	pseudotuberculous
pseudoturbinal	pseudoturbinal
psilotum	psilotum
psychotheism	psychotheism
psychotheist	psychotheist
pterygotus	pterygotus
publicheartedness	publicheartedness
pukateine	pukateine
pureeing	pureeing
purreic	purreic
puzzledness	puzzledness
puzzleheadedness	puzzleheadedness
puzzlepatedness	puzzlepatedness
pycnonotus	pycnonotus
pylorocleisis	pylorocleisis
pyorrheic	pyorrheic
pyorrhoeic	pyorrhoeic
pyrameis	pyrameis
pyrenodeine	pyrenodeine
pyroligneous	pyroligneous
pyrolignic	pyrolignic
pyrolignite	pyrolignite
pyrolignous	pyrolignous
qualifiedness	qualifiedness
quedness	quedness
quei	quei
queing	queing
queintise	queintise
queueing	queueing
quickwittedness	quickwittedness
quillwork	quillwork
quillwort	quillwort
quisqueite	quisqueite
quotum	quotum
raggedness	raggedness
raleigh	raleigh
raleigh's	raleigh's
rashleigh	rashleigh
raveinelike	raveinelike
razeeing	razeeing
razeing	razeing
realign	realign
realigned	realigned
realigning	realigning
realignment	realignment
realignments	realignments
realigns	realigns
reassign	reassign
reassignation	reassignation
reassigned	reassigned
reassigning	reassigning
reassignment	reassignment
reassignments	reassignments
reassigns	reassigns
rebrighten	rebrighten
recampaign	recampaign
receipt	receipt
receiptable	receiptable
receipted	receipted
receipter	receipter
receipting	receipting
receiptless	receiptless
receiptment	receiptment
receiptor	receiptor
receipts	receipts
receiue	receiue
receiued	receiued
receiv'd	receiv'd
receivability	receivability
receivable	receivable
receivableness	receivableness
receivables	receivables
receivablness	receivablness
receival	receival
receive	receive
received	received
receivedness	receivedness
receiver	receiver
receivers	receivers
receivership	receivership
receiverships	receiverships
receives	receives
receiveth	receiveth
receiving	receiving
recollectedness	recollectedness
reconceive	reconceive
reconsign	reconsign
reconsigned	reconsigned
reconsigning	reconsigning
reconsignment	reconsignment
reconsigns	reconsigns
recueil	recueil
recueillement	recueillement
recueilli	recueilli
recueillir	recueillir
recueillis	recueillis
redeceive	redeceive
redeceived	redeceived
redeceiving	redeceiving
redeemedness	redeemedness
redeify	redeify
redesign	redesign
redesignate	redesignate
redesignated	redesignated
redesignating	redesignating
redesignation	redesignation
redesigned	redesigned
redesigning	redesigning
redesigns	redesigns
redhandedness	redhandedness
redheadedness	redheadedness
redisseise	redisseise
redisseisin	redisseisin
redisseisor	redisseisor
redisseize	redisseize
redisseizin	redisseizin
redisseizor	redisseizor
redneck	redneck
rednecks	rednecks
redness	redness
rednesses	rednesses
redyeing	redyeing
reenlighted	reenlighted
reenlighten	reenlighten
reenlightened	reenlightened
reenlightening	reenlightening
reenlightenment	reenlightenment
reenlightens	reenlightens
refeign	refeign
refereeing	refereeing
refinedness	refinedness
reflectedness	reflectedness
reforfeit	reforfeit
reforfeiture	reforfeiture
refractedness	refractedness
refreid	refreid
refreit	refreit
refrighten	refrighten
refugeeism	refugeeism
reguaranteeing	reguaranteeing
reheighten	reheighten
rei	rei
reice	reice
reiced	reiced
reich	reich
reiche	reiche
reichen	reichen
reicher	reicher
reiches	reiches
reichlich	reichlich
reichs	reichs
reichsgulden	reichsgulden
reichsland	reichsland
reichslander	reichslander
reichsmark	reichsmark
reichsmarks	reichsmarks
reichspfennig	reichspfennig
reichstag	reichstag
reichstaler	reichstaler
reichsthaler	reichsthaler
reicht	reicht
reichte	reichte
reichtum	reichtum
reicing	reicing
reid	reid
reidentification	reidentification
reidentified	reidentified
reidentify	reidentify
reidentifying	reidentifying
reif	reif
reification	reification
reified	reified
reifier	reifier
reifiers	reifiers
reifies	reifies
reifs	reifs
reify	reify
reifying	reifying
reign	reign
reigne	reigne
reigned	reigned
reigner	reigner
reigneth	reigneth
reigning	reigning
reignite	reignite
reignited	reignited
reignites	reignites
reigniting	reigniting
reignition	reignition
reignore	reignore
reigns	reigns
reihe	reihe
reihen	reihen
reillume	reillume
reilluminate	reilluminate
reilluminated	reilluminated
reilluminating	reilluminating
reillumination	reillumination
reillumine	reillumine
reillustrate	reillustrate
reillustrated	reillustrated
reillustrating	reillustrating
reillustration	reillustration
reilly	reilly
reim	reim
reimage	reimage
reimaged	reimaged
reimages	reimages
reimagination	reimagination
reimagine	reimagine
reimaging	reimaging
reimbark	reimbark
reimbarkation	reimbarkation
reimbibe	reimbibe
reimbody	reimbody
reimbursable	reimbursable
reimburse	reimburse
reimburseable	reimburseable
reimbursed	reimbursed
reimbursement	reimbursement
reimbursements	reimbursements
reimburser	reimburser
reimburses	reimburses
reimbursing	reimbursing
reimbush	reimbush
reimbushment	reimbushment
reimkennar	reimkennar
reimmerge	reimmerge
reimmerse	reimmerse
reimmersion	reimmersion
reimmigrant	reimmigrant
reimmigration	reimmigration
reimpact	reimpact
reimpark	reimpark
reimpart	reimpart
reimpatriate	reimpatriate
reimpatriation	reimpatriation
reimpel	reimpel
reimplant	reimplant
reimplantation	reimplantation
reimplement	reimplement
reimplemented	reimplemented
reimplied	reimplied
reimply	reimply
reimplying	reimplying
reimport	reimport
reimportation	reimportation
reimported	reimported
reimporting	reimporting
reimports	reimports
reimportune	reimportune
reimpose	reimpose
reimposed	reimposed
reimposes	reimposes
reimposing	reimposing
reimposition	reimposition
reimposure	reimposure
reimpregnate	reimpregnate
reimpregnated	reimpregnated
reimpregnating	reimpregnating
reimpress	reimpress
reimpression	reimpression
reimprint	reimprint
reimprison	reimprison
reimprisoned	reimprisoned
reimprisoning	reimprisoning
reimprisonment	reimprisonment
reimprisons	reimprisons
reimprove	reimprove
reimprovement	reimprovement
reimpulse	reimpulse
reims	reims
rein	rein
reina	reina
reinability	reinability
reinaugurate	reinaugurate
reinaugurated	reinaugurated
reinaugurating	reinaugurating
reinauguration	reinauguration
reincapable	reincapable
reincarnadine	reincarnadine
reincarnate	reincarnate
reincarnated	reincarnated
reincarnates	reincarnates
reincarnating	reincarnating
reincarnation	reincarnation
reincarnationism	reincarnationism
reincarnationist	reincarnationist
reincarnationists	reincarnationists
reincarnations	reincarnations
reincense	reincense
reincentive	reincentive
reincidence	reincidence
reincidency	reincidency
reincite	reincite
reincited	reincited
reincites	reincites
reinciting	reinciting
reinclination	reinclination
reincline	reincline
reinclined	reinclined
reinclining	reinclining
reinclude	reinclude
reincluded	reincluded
reincluding	reincluding
reinclusion	reinclusion
reincorporate	reincorporate
reincorporated	reincorporated
reincorporates	reincorporates
reincorporating	reincorporating
reincorporation	reincorporation
reincrease	reincrease
reincreased	reincreased
reincreasing	reincreasing
reincrudate	reincrudate
reincrudation	reincrudation
reinculcate	reinculcate
reincur	reincur
reincurred	reincurred
reincurring	reincurring
reincurs	reincurs
reindebted	reindebted
reindebtedness	reindebtedness
reindeer	reindeer
reindeers	reindeers
reindependence	reindependence
reindex	reindex
reindexed	reindexed
reindexes	reindexes
reindexing	reindexing
reindicate	reindicate
reindicated	reindicated
reindicating	reindicating
reindication	reindication
reindict	reindict
reindictment	reindictment
reindifferent	reindifferent
reindoctrinate	reindoctrinate
reindoctrinated	reindoctrinated
reindoctrinating	reindoctrinating
reindoctrination	reindoctrination
reindorse	reindorse
reindorsed	reindorsed
reindorsement	reindorsement
reindorsing	reindorsing
reinduce	reinduce
reinduced	reinduced
reinducement	reinducement
reinduces	reinduces
reinducing	reinducing
reinduct	reinduct
reinducted	reinducted
reinducting	reinducting
reinduction	reinduction
reinducts	reinducts
reindue	reindue
reindulge	reindulge
reindulged	reindulged
reindulgence	reindulgence
reindulging	reindulging
reindustrialization	reindustrialization
reindustrialize	reindustrialize
reindustrialized	reindustrialized
reindustrializing	reindustrializing
reine	reine
reined	reined
reineke	reineke
reinen	reinen
reiner	reiner
reines	reines
reinette	reinette
reinfect	reinfect
reinfected	reinfected
reinfecting	reinfecting
reinfection	reinfection
reinfections	reinfections
reinfectious	reinfectious
reinfects	reinfects
reinfer	reinfer
reinferred	reinferred
reinferring	reinferring
reinfest	reinfest
reinfestation	reinfestation
reinfiltrate	reinfiltrate
reinfiltrated	reinfiltrated
reinfiltrating	reinfiltrating
reinfiltration	reinfiltration
reinflame	reinflame
reinflamed	reinflamed
reinflames	reinflames
reinflaming	reinflaming
reinflatable	reinflatable
reinflate	reinflate
reinflated	reinflated
reinflating	reinflating
reinflation	reinflation
reinflict	reinflict
reinfliction	reinfliction
reinfluence	reinfluence
reinfluenced	reinfluenced
reinfluencing	reinfluencing
reinforce	reinforce
reinforceable	reinforceable
reinforced	reinforced
reinforcement	reinforcement
reinforcements	reinforcements
reinforcer	reinforcer
reinforcers	reinforcers
reinforces	reinforces
reinforcing	reinforcing
reinform	reinform
reinformed	reinformed
reinforming	reinforming
reinforms	reinforms
reinfund	reinfund
reinfuse	reinfuse
reinfused	reinfused
reinfuses	reinfuses
reinfusing	reinfusing
reinfusion	reinfusion
reingraft	reingraft
reingratiate	reingratiate
reingress	reingress
reinhabit	reinhabit
reinhabitation	reinhabitation
reinhard	reinhard
reinherit	reinherit
reining	reining
reinitialize	reinitialize
reinitialized	reinitialized
reinitializes	reinitializes
reinitializing	reinitializing
reinitiate	reinitiate
reinitiation	reinitiation
reinject	reinject
reinjure	reinjure
reinjured	reinjured
reinjures	reinjures
reinjuries	reinjuries
reinjuring	reinjuring
reinjury	reinjury
reink	reink
reinked	reinked
reinking	reinking
reinks	reinks
reinless	reinless
reino	reino
reinoculate	reinoculate
reinoculated	reinoculated
reinoculates	reinoculates
reinoculating	reinoculating
reinoculation	reinoculation
reinoculations	reinoculations
reinquire	reinquire
reinquired	reinquired
reinquiries	reinquiries
reinquiring	reinquiring
reinquiry	reinquiry
reins	reins
reinsane	reinsane
reinsanity	reinsanity
reinscribe	reinscribe
reinscribed	reinscribed
reinscribes	reinscribes
reinscribing	reinscribing
reinsert	reinsert
reinserted	reinserted
reinserting	reinserting
reinsertion	reinsertion
reinserts	reinserts
reinsist	reinsist
reinsman	reinsman
reinsmen	reinsmen
reinspect	reinspect
reinspected	reinspected
reinspecting	reinspecting
reinspection	reinspection
reinspector	reinspector
reinspects	reinspects
reinsphere	reinsphere
reinspiration	reinspiration
reinspire	reinspire
reinspired	reinspired
reinspiring	reinspiring
reinspirit	reinspirit
reinstall	reinstall
reinstallation	reinstallation
reinstallations	reinstallations
reinstalled	reinstalled
reinstalling	reinstalling
reinstallment	reinstallment
reinstallments	reinstallments
reinstalls	reinstalls
reinstalment	reinstalment
reinstate	reinstate
reinstated	reinstated
reinstatement	reinstatement
reinstatements	reinstatements
reinstates	reinstates
reinstating	reinstating
reinstation	reinstation
reinstator	reinstator
reinstauration	reinstauration
reinstil	reinstil
reinstill	reinstill
reinstitute	reinstitute
reinstituted	reinstituted
reinstituting	reinstituting
reinstitution	reinstitution
reinstruct	reinstruct
reinstructed	reinstructed
reinstructing	reinstructing
reinstruction	reinstruction
reinstructs	reinstructs
reinsulate	reinsulate
reinsulated	reinsulated
reinsulating	reinsulating
reinsult	reinsult
reinsurance	reinsurance
reinsure	reinsure
reinsured	reinsured
reinsurer	reinsurer
reinsures	reinsures
reinsuring	reinsuring
reintegrate	reintegrate
reintegrated	reintegrated
reintegrates	reintegrates
reintegrating	reintegrating
reintegration	reintegration
reintegrative	reintegrative
reintend	reintend
reinter	reinter
reintercede	reintercede
reintercession	reintercession
reinterchange	reinterchange
reinterest	reinterest
reinterfere	reinterfere
reinterference	reinterference
reinterment	reinterment
reinterpret	reinterpret
reinterpretation	reinterpretation
reinterpretations	reinterpretations
reinterpreted	reinterpreted
reinterpreting	reinterpreting
reinterprets	reinterprets
reinterred	reinterred
reinterring	reinterring
reinterrogate	reinterrogate
reinterrogated	reinterrogated
reinterrogates	reinterrogates
reinterrogating	reinterrogating
reinterrogation	reinterrogation
reinterrogations	reinterrogations
reinterrupt	reinterrupt
reinterruption	reinterruption
reinters	reinters
reintervene	reintervene
reintervened	reintervened
reintervening	reintervening
reintervention	reintervention
reinterview	reinterview
reinthrone	reinthrone
reintimate	reintimate
reintimation	reintimation
reintitule	reintitule
reintrench	reintrench
reintrenched	reintrenched
reintrenches	reintrenches
reintrenching	reintrenching
reintrenchment	reintrenchment
reintroduce	reintroduce
reintroduced	reintroduced
reintroduces	reintroduces
reintroducing	reintroducing
reintroduction	reintroduction
reintrude	reintrude
reintrusion	reintrusion
reintuition	reintuition
reintuitive	reintuitive
reinvade	reinvade
reinvaded	reinvaded
reinvading	reinvading
reinvasion	reinvasion
reinvent	reinvent
reinvented	reinvented
reinventing	reinventing
reinvention	reinvention
reinventor	reinventor
reinvents	reinvents
reinversion	reinversion
reinvert	reinvert
reinvest	reinvest
reinvested	reinvested
reinvestigate	reinvestigate
reinvestigated	reinvestigated
reinvestigates	reinvestigates
reinvestigating	reinvestigating
reinvestigation	reinvestigation
reinvestigations	reinvestigations
reinvesting	reinvesting
reinvestiture	reinvestiture
reinvestment	reinvestment
reinvests	reinvests
reinvigorate	reinvigorate
reinvigorated	reinvigorated
reinvigorates	reinvigorates
reinvigorating	reinvigorating
reinvigoration	reinvigoration
reinvigorator	reinvigorator
reinvitation	reinvitation
reinvite	reinvite
reinvited	reinvited
reinvites	reinvites
reinviting	reinviting
reinvoice	reinvoice
reinvoke	reinvoke
reinvoked	reinvoked
reinvokes	reinvokes
reinvoking	reinvoking
reinvolve	reinvolve
reinvolved	reinvolved
reinvolvement	reinvolvement
reinvolves	reinvolves
reinvolving	reinvolving
reinwardtia	reinwardtia
reirrigate	reirrigate
reirrigated	reirrigated
reirrigating	reirrigating
reirrigation	reirrigation
reis	reis
reise	reise
reisen	reisen
reisenden	reisenden
reisner	reisner
reisolate	reisolate
reisolated	reisolated
reisolating	reisolating
reisolation	reisolation
reissuable	reissuable
reissuably	reissuably
reissue	reissue
reissued	reissued
reissuement	reissuement
reissuer	reissuer
reissuers	reissuers
reissues	reissues
reissuing	reissuing
reist	reist
reiste	reiste
reister	reister
reit	reit
reitbok	reitbok
reitboks	reitboks
reitbuck	reitbuck
reitemize	reitemize
reitemized	reitemized
reitemizing	reitemizing
reiten	reiten
reiter	reiter
reiterable	reiterable
reiterance	reiterance
reiterant	reiterant
reiterate	reiterate
reiterated	reiterated
reiteratedly	reiteratedly
reiteratedness	reiteratedness
reiterates	reiterates
reiterating	reiterating
reiteration	reiteration
reiterations	reiterations
reiterative	reiterative
reiteratively	reiteratively
reiterativeness	reiterativeness
reiterator	reiterator
reive	reive
reived	reived
reiver	reiver
reivers	reivers
reives	reives
reiving	reiving
reiz	reiz
reize	reize
reizen	reizen
reizend	reizend
reizigers	reizigers
relatedness	relatedness
relaxedness	relaxedness
releivo	releivo
releivos	releivos
relighted	relighted
relighten	relighten
relightener	relightener
relighter	relighter
relishsome	relishsome
removedness	removedness
renewedness	renewedness
renownedness	renownedness
renseignements	renseignements
reparteeist	reparteeist
reperceive	reperceive
reperceived	reperceived
reperceiving	reperceiving
reposedness	reposedness
rereign	rereign
reseeing	reseeing
reseise	reseise
reseiser	reseiser
reseize	reseize
reseized	reseized
reseizer	reseizer
reseizes	reseizes
reseizing	reseizing
reseizure	reseizure
reservedness	reservedness
reshoeing	reshoeing
resign	resign
resignal	resignal
resignaled	resignaled
resignaling	resignaling
resignatary	resignatary
resignation	resignation
resignationism	resignationism
resignations	resignations
resigned	resigned
resignedly	resignedly
resignedness	resignedness
resignee	resignee
resigner	resigner
resigners	resigners
resignful	resignful
resigning	resigning
resignment	resignment
resigns	resigns
resolvedness	resolvedness
resorcinolphthalein	resorcinolphthalein
restraighten	restraighten
restraightened	restraightened
restraightening	restraightening
restraightens	restraightens
restrainedness	restrainedness
restrictedness	restrictedness
resumeing	resumeing
retieing	retieing
retighten	retighten
retingeing	retingeing
retiredness	retiredness
reveil	reveil
reveille	reveille
reveiller	reveiller
reveilles	reveilles
reweigh	reweigh
reweighed	reweighed
reweigher	reweigher
reweighing	reweighing
reweighs	reweighs
reweight	reweight
rhamnetin	rhamnetin
rheic	rheic
rheidae	rheidae
rheiformes	rheiformes
rheims	rheims
rhein	rhein
rheinberry	rheinberry
rheingold	rheingold
rheinic	rheinic
rhomboganoidei	rhomboganoidei
rhomboidei	rhomboidei
rhythmopoeia	rhythmopoeia
ribonucleic	ribonucleic
ribonucleoprotein	ribonucleoprotein
richter	richter
richterite	richterite
ricinoleic	ricinoleic
ricinolein	ricinolein
ricinulei	ricinulei
rifleite	rifleite
righted	righted
righten	righten
righteous	righteous
righteously	righteously
righteousness	righteousness
righter	righter
righters	righters
rightest	rightest
rignum	rignum
rinneite	rinneite
rogueing	rogueing
roiledness	roiledness
romanceish	romanceish
romanceishness	romanceishness
romeine	romeine
romeite	romeite
rootedness	rootedness
roseine	roseine
rottenmeier	rottenmeier
rottweiler	rottweiler
rotula	rotula
rotulad	rotulad
rotular	rotular
rotulet	rotulet
rotulian	rotulian
rotuliform	rotuliform
rotulus	rotulus
rotund	rotund
rotunda	rotunda
rotundas	rotundas
rotundate	rotundate
rotundifoliate	rotundifoliate
rotundifolious	rotundifolious
rotundiform	rotundiform
rotundify	rotundify
rotundities	rotundities
rotundity	rotundity
rotundly	rotundly
rotundness	rotundness
rotundo	rotundo
rotundotetragonal	rotundotetragonal
roture	roture
roturier	roturier
roturiers	roturiers
roughheartedness	roughheartedness
roughsome	roughsome
roundedness	roundedness
roundheadedness	roundheadedness
rousedness	rousedness
rowleian	rowleian
rubinstein	rubinstein
rudesheimer	rudesheimer
rugbeian	rugbeian
ruggedness	ruggedness
rushlighted	rushlighted
réveil	réveil
réveilla	réveilla
réveiller	réveiller
réveillé	réveillé
sabaeism	sabaeism
sabeing	sabeing
saccharineish	saccharineish
sacredness	sacredness
sacrotuberous	sacrotuberous
sadduceeism	sadduceeism
sadduceeist	sadduceeist
sadheartedness	sadheartedness
sadleir	sadleir
saebeins	saebeins
saeima	saeima
saignant	saignant
saleeite	saleeite
salmonoidei	salmonoidei
sandalwood	sandalwood
sandalwoods	sandalwoods
sandalwort	sandalwort
sanemindedness	sanemindedness
sangei	sangei
sansei	sansei
sanseis	sanseis
santalwood	santalwood
sapheadedness	sapheadedness
satedness	satedness
satisfiedness	satisfiedness
saturatedness	saturatedness
satureia	satureia
sauteing	sauteing
scabbedness	scabbedness
scarabaei	scarabaei
scarabaeid	scarabaeid
scarabaeidae	scarabaeidae
scarabaeidoid	scarabaeidoid
scarabaeiform	scarabaeiform
scarabaeinae	scarabaeinae
scatteredness	scatteredness
schalmei	schalmei
schalstein	schalstein
scheiden	scheiden
schein	schein
scheinbar	scheinbar
scheinen	scheinen
scheint	scheint
schizonotus	schizonotus
schleichera	schleichera
schleier	schleier
schleiermacher	schleiermacher
schmeiss	schmeiss
schneider	schneider
schneiderian	schneiderian
schoenheit	schoenheit
schoolwork	schoolwork
schoonheid	schoonheid
schrei	schrei
schreiben	schreiben
schreiber	schreiber
schreibersite	schreibersite
schreibt	schreibt
schreibtisch	schreibtisch
schreien	schreien
schreiner	schreiner
schreinerize	schreinerize
schreinerized	schreinerized
schreinerizing	schreinerizing
schreit	schreit
schriesheimite	schriesheimite
schulmeister	schulmeister
schwarmerei	schwarmerei
schweigen	schweigen
schweigend	schweigend
schweitzer	schweitzer
schweiz	schweiz
schweizer	schweizer
schweizerkase	schweizerkase
schwierigkeit	schwierigkeit
schwierigkeiten	schwierigkeiten
schönheit	schönheit
sciotheism	sciotheism
sclereid	sclereid
sclereids	sclereids
scleroparei	scleroparei
scleroprotein	scleroprotein
scopoleine	scopoleine
scraggedness	scraggedness
screich	screich
screigh	screigh
scribbleism	scribbleism
scrofulotuberculous	scrofulotuberculous
scrollwork	scrollwork
scrotum	scrotum
scrotums	scrotums
scyllaeidae	scyllaeidae
sdeign	sdeign
seafighter	seafighter
sealwort	sealwort
searedness	searedness
seborrheic	seborrheic
seborrhoeic	seborrhoeic
secludedness	secludedness
secondhandedness	secondhandedness
secondsighted	secondsighted
secondsightedness	secondsightedness
seedness	seedness
seein'	seein'
seeing	seeing
seeingly	seeingly
seeingness	seeingness
seeings	seeings
segregatedness	segregatedness
segueing	segueing
sei	sei
seicento	seicento
seicentos	seicentos
seiche	seiche
seiches	seiches
seid	seid
seide	seide
seidel	seidel
seidels	seidels
seidlitz	seidlitz
seien	seien
seif	seif
seifs	seifs
seige	seige
seigneur	seigneur
seigneurage	seigneurage
seigneuress	seigneuress
seigneurial	seigneurial
seigneurie	seigneurie
seigneurs	seigneurs
seigneury	seigneury
seignior	seignior
seigniorage	seigniorage
seignioral	seignioral
seignioralty	seignioralty
seigniorial	seigniorial
seigniories	seigniories
seigniority	seigniority
seigniors	seigniors
seigniorship	seigniorship
seigniory	seigniory
seignorage	seignorage
seignoral	seignoral
seignorial	seignorial
seignories	seignories
seignorize	seignorize
seignory	seignory
seikka	seikka
seilenoi	seilenoi
seilenos	seilenos
seimas	seimas
sein	sein
seine	seine
seined	seined
seinem	seinem
seinen	seinen
seiner	seiner
seiners	seiners
seines	seines
seingalt	seingalt
seining	seining
seins	seins
seir	seir
seiren	seiren
seirospore	seirospore
seirosporic	seirosporic
seis	seis
seisable	seisable
seise	seise
seised	seised
seiser	seiser
seisers	seisers
seises	seises
seisin	seisin
seising	seising
seisings	seisings
seisins	seisins
seism	seism
seismal	seismal
seismatical	seismatical
seismetic	seismetic
seismic	seismic
seismical	seismical
seismically	seismically
seismicity	seismicity
seismism	seismism
seismisms	seismisms
seismochronograph	seismochronograph
seismogram	seismogram
seismograms	seismograms
seismograph	seismograph
seismographer	seismographer
seismographers	seismographers
seismographic	seismographic
seismographical	seismographical
seismographs	seismographs
seismography	seismography
seismol	seismol
seismologic	seismologic
seismological	seismological
seismologically	seismologically
seismologist	seismologist
seismologists	seismologists
seismologue	seismologue
seismology	seismology
seismometer	seismometer
seismometers	seismometers
seismometric	seismometric
seismometrical	seismometrical
seismometrograph	seismometrograph
seismometry	seismometry
seismomicrophone	seismomicrophone
seismoscope	seismoscope
seismoscopic	seismoscopic
seismotectonic	seismotectonic
seismotherapy	seismotherapy
seismotic	seismotic
seisms	seisms
seisoi	seisoi
seisoivat	seisoivat
seisomaan	seisomaan
seisoo	seisoo
seisor	seisor
seisors	seisors
seisure	seisure
seisures	seisures
seit	seit
seitan	seitan
seitans	seitans
seitdem	seitdem
seite	seite
seiten	seiten
seity	seity
seitz	seitz
seiurus	seiurus
seiyuhonto	seiyuhonto
seiyukai	seiyukai
seiz'd	seiz'd
seizable	seizable
seize	seize
seized	seized
seizer	seizer
seizers	seizers
seizes	seizes
seizin	seizin
seizing	seizing
seizings	seizings
seizins	seizins
seizor	seizor
seizors	seizors
seizure	seizure
seizures	seizures
selachoidei	selachoidei
selbstbewusstsein	selbstbewusstsein
selbstbewußtsein	selbstbewußtsein
seligkeit	seligkeit
semeia	semeia
semeiography	semeiography
semeiologic	semeiologic
semeiological	semeiological
semeiologist	semeiologist
semeiology	semeiology
semeion	semeion
semeiotic	semeiotic
semeiotical	semeiotical
semeiotics	semeiotics
semiatheist	semiatheist
semideific	semideific
semideification	semideification
semideify	semideify
semideistical	semideistical
semideity	semideity
semidiaphaneity	semidiaphaneity
semiforeign	semiforeign
semiligneous	semiligneous
semimalignant	semimalignant
semimalignantly	semimalignantly
semionotus	semionotus
semirotund	semirotund
semirotunda	semirotunda
semisightseeing	semisightseeing
semisovereignty	semisovereignty
semispontaneity	semispontaneity
sensei	sensei
senseis	senseis
serein	serein
sereine	sereine
sereins	sereins
sergei	sergei
serpentcleide	serpentcleide
serriedness	serriedness
settledness	settledness
shaggedness	shaggedness
shamefacedness	shamefacedness
sheepfacedness	sheepfacedness
sheik	sheik
sheikdom	sheikdom
sheikdoms	sheikdoms
sheikh	sheikh
sheikhdom	sheikhdom
sheikhlike	sheikhlike
sheikhly	sheikhly
sheikhs	sheikhs
sheiklike	sheiklike
sheikly	sheikly
sheiks	sheiks
sheila	sheila
sheila's	sheila's
sheilas	sheilas
sheiling	sheiling
sheitan	sheitan
sheitans	sheitans
sheitel	sheitel
sheitlen	sheitlen
shellwork	shellwork
shellworker	shellworker
shimei	shimei
shipwrightery	shipwrightery
shivareeing	shivareeing
shockedness	shockedness
shockheadedness	shockheadedness
shoeing	shoeing
shoeingsmith	shoeingsmith
shorthandedness	shorthandedness
shortsighted	shortsighted
shortsightedly	shortsightedly
shortsightedness	shortsightedness
shtetel	shtetel
shtetl	shtetl
shtetlach	shtetlach
shtreimel	shtreimel
sialosemeiology	sialosemeiology
sicherheit	sicherheit
sidedness	sidedness
sighted	sighted
sightedness	sightedness
sighten	sighten
sightening	sightening
sighter	sighter
sighters	sighters
sightseeing	sightseeing
sign	sign
signa	signa
signable	signable
signacle	signacle
signal	signal
signaled	signaled
signalee	signalee
signaler	signaler
signalers	signalers
signalese	signalese
signaletic	signaletic
signaletics	signaletics
signaling	signaling
signalise	signalise
signalised	signalised
signalising	signalising
signalism	signalism
signalist	signalist
signalities	signalities
signality	signality
signalization	signalization
signalize	signalize
signalized	signalized
signalizes	signalizes
signalizing	signalizing
signalled	signalled
signaller	signaller
signalling	signalling
signally	signally
signalman	signalman
signalmen	signalmen
signalment	signalment
signals	signals
signance	signance
signary	signary
signatary	signatary
signate	signate
signation	signation
signator	signator
signatories	signatories
signatory	signatory
signatural	signatural
signature	signature
signatured	signatured
signatureless	signatureless
signatures	signatures
signaturing	signaturing
signaturist	signaturist
signboard	signboard
signboards	signboards
signed	signed
signee	signee
signer	signer
signers	signers
signet	signet
signeted	signeted
signeting	signeting
signets	signets
signetur	signetur
signetwise	signetwise
signeur	signeur
signeury	signeury
signifer	signifer
signifiable	signifiable
signifiant	signifiant
signific	signific
significal	significal
significance	significance
significancies	significancies
significancy	significancy
significand	significand
significant	significant
significantly	significantly
significantness	significantness
significants	significants
significate	significate
signification	signification
significations	significations
significatist	significatist
significative	significative
significatively	significatively
significativeness	significativeness
significator	significator
significatory	significatory
significatrix	significatrix
significatum	significatum
significature	significature
significavit	significavit
significian	significian
significs	significs
signifie	signifie
signified	signified
signifier	signifier
signifies	signifies
signify	signify
signifying	signifying
signing	signing
signior	signior
signiori	signiori
signiories	signiories
signiors	signiors
signiorship	signiorship
signiory	signiory
signist	signist
signitor	signitor
signless	signless
signlike	signlike
signman	signman
signoff	signoff
signoi	signoi
signon	signon
signons	signons
signor	signor
signora	signora
signoras	signoras
signore	signore
signori	signori
signoria	signoria
signorial	signorial
signories	signories
signorina	signorina
signorinas	signorinas
signorine	signorine
signorini	signorini
signorino	signorino
signorinos	signorinos
signorize	signorize
signors	signors
signorship	signorship
signory	signory
signpost	signpost
signposted	signposted
signposting	signposting
signposts	signposts
signs	signs
signum	signum
signwriter	signwriter
silicotungstate	silicotungstate
silicotungstic	silicotungstic
siluroidei	siluroidei
simpleheartedness	simpleheartedness
simplemindedness	simplemindedness
simultaneity	simultaneity
singeing	singeing
singeingly	singeingly
singlehandedness	singlehandedness
singleheartedness	singleheartedness
sinnlichkeit	sinnlichkeit
sirenoidei	sirenoidei
sizeine	sizeine
skeeing	skeeing
skeich	skeich
skeif	skeif
skeigh	skeigh
skeighish	skeighish
skeily	skeily
skein	skein
skeined	skeined
skeiner	skeiner
skeining	skeining
skeins	skeins
skeipp	skeipp
skreigh	skreigh
skreighed	skreighed
skreighing	skreighing
skreighs	skreighs
slackmindedness	slackmindedness
slackwittedness	slackwittedness
slaughter	slaughter
slaughterdom	slaughterdom
slaughtered	slaughtered
slaughterer	slaughterer
slaughterers	slaughterers
slaughterhouse	slaughterhouse
slaughterhouses	slaughterhouses
slaughtering	slaughtering
slaughteringly	slaughteringly
slaughterman	slaughterman
slaughterous	slaughterous
slaughterously	slaughterously
slaughters	slaughters
slaughtery	slaughtery
slaughteryard	slaughteryard
sleided	sleided
sleigh	sleigh
sleighed	sleighed
sleigher	sleigher
sleighers	sleighers
sleighing	sleighing
sleighs	sleighs
sleight	sleight
sleightful	sleightful
sleightness	sleightness
sleights	sleights
sleighty	sleighty
slighted	slighted
slighten	slighten
slighter	slighter
slightest	slightest
slowheartedness	slowheartedness
smithsonian	smithsonian
smithsonite	smithsonite
smittleish	smittleish
snelheid	snelheid
snowshoeing	snowshoeing
sobeit	sobeit
sobersidedness	sobersidedness
societeit	societeit
softheadedness	softheadedness
softheartedness	softheartedness
sogleich	sogleich
soign	soign
soigne	soigne
soignee	soignee
soiledness	soiledness
solanein	solanein
solaneine	solaneine
solei	solei
soleidae	soleidae
soleiform	soleiform
soleil	soleil
solein	solein
sombreish	sombreish
sombreite	sombreite
sommeil	sommeil
sonnenschein	sonnenschein
soogeeing	soogeeing
soogeing	soogeing
soreheadedness	soreheadedness
sortieing	sortieing
sottedness	sottedness
souffleing	souffleing
soundheadedness	soundheadedness
soundheartednes	soundheartednes
soundheartedness	soundheartedness
souredness	souredness
sovereign	sovereign
sovereign's	sovereign's
sovereigness	sovereigness
sovereignize	sovereignize
sovereignly	sovereignly
sovereignness	sovereignness
sovereigns	sovereigns
sovereignship	sovereignship
sovereignties	sovereignties
sovereignty	sovereignty
soweit	soweit
spaeing	spaeing
spaeings	spaeings
spartein	spartein
sparteine	sparteine
speckedness	speckedness
speckledness	speckledness
speight	speight
speil	speil
speiled	speiled
speiling	speiling
speils	speils
speir	speir
speired	speired
speiring	speiring
speirs	speirs
speise	speise
speisen	speisen
speises	speises
speiskobalt	speiskobalt
speiss	speiss
speisscobalt	speisscobalt
speisses	speisses
spellword	spellword
spellwork	spellwork
sphenoturbinal	sphenoturbinal
spiegeleisen	spiegeleisen
spignel	spignel
spignet	spignet
spignut	spignut
spikedness	spikedness
spinosotubercular	spinosotubercular
spinosotuberculate	spinosotuberculate
spinotuberculous	spinotuberculous
spirignath	spirignath
spirignathous	spirignathous
spiritedness	spiritedness
splenocleisis	splenocleisis
spontaneities	spontaneities
spontaneity	spontaneity
spoolwood	spoolwood
spotlighter	spotlighter
spottedness	spottedness
spreeing	spreeing
sprighted	sprighted
springeing	springeing
spritehood	spritehood
spurreies	spurreies
squaloidei	squaloidei
squamatotuberculate	squamatotuberculate
squatinoidei	squatinoidei
squeegeeing	squeegeeing
squeegeing	squeegeing
squilgeeing	squilgeeing
squilgeing	squilgeing
squillageeing	squillageeing
squillageing	squillageing
squillgeeing	squillgeeing
squillgeing	squillgeing
stalworth	stalworth
stalworthly	stalworthly
stalworthness	stalworthness
standelwort	standelwort
starchedness	starchedness
starlighted	starlighted
statehood	statehood
statehouse	statehouse
statehouses	statehouses
steelwork	steelwork
steelworker	steelworker
steelworking	steelworking
steelworks	steelworks
steid	steid
steigen	steigen
steigh	steigh
steigt	steigt
steil	steil
steile	steile
stein	stein
steinbeck	steinbeck
steinberger	steinberger
steinbock	steinbock
steinbok	steinbok
steinboks	steinboks
steinbuck	steinbuck
steine	steine
steinen	steinen
steinerian	steinerian
steinful	steinful
steinkirk	steinkirk
steinmetz	steinmetz
steins	steins
steironema	steironema
stenopaeic	stenopaeic
stenopeic	stenopeic
stepdaughter	stepdaughter
stepdaughters	stepdaughters
stereid	stereid
sternocleidomastoid	sternocleidomastoid
sternocleidomastoideus	sternocleidomastoideus
stiffneckedness	stiffneckedness
stiltedness	stiltedness
stingareeing	stingareeing
stintedness	stintedness
stippledness	stippledness
stogeies	stogeies
stoicheiology	stoicheiology
stoicheiometrically	stoicheiometrically
stoicheiometry	stoicheiometry
stoneite	stoneite
stonyheartedness	stonyheartedness
stoutheartedness	stoutheartedness
straighted	straighted
straightedge	straightedge
straightedged	straightedged
straightedges	straightedges
straightedging	straightedging
straighten	straighten
straightened	straightened
straightener	straightener
straighteners	straighteners
straightening	straightening
straightens	straightens
straighter	straighter
straightest	straightest
strainedness	strainedness
straitlacedness	straitlacedness
strandedness	strandedness
stratofreighter	stratofreighter
strauchten	strauchten
streahte	streahte
streakedness	streakedness
streetfighter	streetfighter
streich	streich
streifen	streifen
streight	streight
streit	streit
streite	streite
stringhaltedness	stringhaltedness
stromateid	stromateid
stromateidae	stromateidae
strongheadedness	strongheadedness
stubbedness	stubbedness
studiedness	studiedness
stuntedness	stuntedness
stupefiedness	stupefiedness
stymieing	stymieing
subclei	subclei
subduedness	subduedness
subjectedness	subjectedness
sublighted	sublighted
subnuclei	subnuclei
subrotund	subrotund
subrotundity	subrotundity
subrotundly	subrotundly
subrotundness	subrotundness
subsign	subsign
subsovereign	subsovereign
subterraneity	subterraneity
subvein	subvein
subweight	subweight
sufeism	sufeism
suggestedness	suggestedness
suitedness	suitedness
suleiman	suleiman
sulfoleic	sulfoleic
sulfonephthalein	sulfonephthalein
sulfophthalein	sulfophthalein
sulforicinoleic	sulforicinoleic
sulliedness	sulliedness
sulpholeic	sulpholeic
sulphonephthalein	sulphonephthalein
sulphonphthalein	sulphonphthalein
sulphophthalein	sulphophthalein
sulphoproteid	sulphoproteid
sulphoricinoleic	sulphoricinoleic
sulphotungstate	sulphotungstate
sulphotungstic	sulphotungstic
sulphureity	sulphureity
summerweight	summerweight
sunburnedness	sunburnedness
sunlighted	sunlighted
sunnyheartedness	sunnyheartedness
sunspottedness	sunspottedness
superbenign	superbenign
superbenignly	superbenignly
superblessedness	superblessedness
superdeities	superdeities
superdeity	superdeity
superguaranteeing	superguaranteeing
superheatedness	superheatedness
superignorant	superignorant
superignorantly	superignorantly
superindignant	superindignant
superindignantly	superindignantly
superpopulatedness	superpopulatedness
superrighteous	superrighteous
superrighteously	superrighteously
superrighteousness	superrighteousness
supersignificant	supersignificant
supersignificantly	supersignificantly
supersovereign	supersovereign
supersovereignty	supersovereignty
surefootedness	surefootedness
surfeit	surfeit
surfeited	surfeited
surfeitedness	surfeitedness
surfeiter	surfeiter
surfeiting	surfeiting
surfeits	surfeits
surrein	surrein
surveil	surveil
surveiled	surveiled
surveiling	surveiling
surveillance	surveillance
surveillant	surveillant
surveiller	surveiller
surveilling	surveilling
surveils	surveils
suspectedness	suspectedness
sutteeism	sutteeism
svein	svein
sweetheartedness	sweetheartedness
swellheadedness	swellheadedness
swingeing	swingeing
swingeingly	swingeingly
sydneian	sydneian
symbolofideism	symbolofideism
synapheia	synapheia
synchroneity	synchroneity
syneidesis	syneidesis
syngeneic	syngeneic
tableity	tableity
tachypneic	tachypneic
tachypnoeic	tachypnoeic
tachyseism	tachyseism
taetigkeit	taetigkeit
taintedness	taintedness
taipei	taipei
takeing	takeing
tallwood	tallwood
talwood	talwood
tameheartedness	tameheartedness
tamein	tamein
tameins	tameins
tangeite	tangeite
tannocaffeic	tannocaffeic
tapeinocephalic	tapeinocephalic
tapeinocephalism	tapeinocephalism
tapeinocephaly	tapeinocephaly
tapferkeit	tapferkeit
tarpeia	tarpeia
tarpeian	tarpeian
tatteredness	tatteredness
tawneier	tawneier
tawneiest	tawneiest
tcheirek	tcheirek
teaselwort	teaselwort
teeing	teeing
teetotum	teetotum
teetotumism	teetotumism
teetotumize	teetotumize
teetotums	teetotums
teetotumwise	teetotumwise
tegenwoordigheid	tegenwoordigheid
tehee	tehee
teheran	teheran
tehseel	tehseel
tehseeldar	tehseeldar
tehsil	tehsil
tehsildar	tehsildar
tehuantepecan	tehuantepecan
tehueco	tehueco
tehuelche	tehuelche
tehuelchean	tehuelchean
tehuelet	tehuelet
teian	teian
teicher	teicher
teichopsia	teichopsia
teidän	teidän
teidät	teidät
teiglach	teiglach
teiglech	teiglech
teihte	teihte
teiid	teiid
teiidae	teiidae
teiids	teiids
teil	teil
teile	teile
teilen	teilen
teille	teille
teillä	teillä
teilnahme	teilnahme
teils	teils
teilte	teilte
teilung	teilung
teilweise	teilweise
tein	tein
teind	teind
teindable	teindable
teinder	teinder
teinds	teinds
teinland	teinland
teinoscope	teinoscope
teint	teint
teinte	teinte
teintes	teintes
teioid	teioid
teiresias	teiresias
teise	teise
teitä	teitä
telei	telei
teleia	teleia
teleianthous	teleianthous
teleiosis	teleiosis
teleostei	teleostei
teleseism	teleseism
teleseismic	teleseismic
teleseismology	teleseismology
tellheim	tellheim
tembeitera	tembeitera
temperedness	temperedness
tenderheartedness	tenderheartedness
terreity	terreity
terreplein	terreplein
tetotum	tetotum
tetotums	tetotums
tetrabromofluorescein	tetrabromofluorescein
tetraiodophenolphthalein	tetraiodophenolphthalein
tetratheism	tetratheism
tetratheist	tetratheist
tetratheite	tetratheite
thei	thei
theiform	theiform
theil	theil
theile	theile
theileria	theileria
theim	theim
thein	thein
theine	theine
theines	theines
theinism	theinism
theins	theins
their	their
theirn	theirn
theirs	theirs
theirselves	theirselves
theirsens	theirsens
theism	theism
theisms	theisms
theist	theist
theistic	theistic
theistical	theistical
theistically	theistically
theists	theists
theologeion	theologeion
therein	therein
thereinafter	thereinafter
thereinbefore	thereinbefore
thereinto	thereinto
theriotheism	theriotheism
theriotheist	theriotheist
thermopleion	thermopleion
thermopolypneic	thermopolypneic
thickheadedness	thickheadedness
thioneine	thioneine
thiotungstate	thiotungstate
thiotungstic	thiotungstic
tholeiite	tholeiite
tholeiitic	tholeiitic
tholeite	tholeite
thoracostei	thoracostei
thorgeir	thorgeir
thoroughbredness	thoroughbredness
thorstein	thorstein
thortveitite	thortveitite
thoughted	thoughted
thoughten	thoughten
thousandweight	thousandweight
threefoldedness	threefoldedness
threip	threip
throeing	throeing
thuggeeism	thuggeeism
thymolphthalein	thymolphthalein
thymolsulphonephthalein	thymolsulphonephthalein
thymonucleic	thymonucleic
thyreoprotein	thyreoprotein
thyroprotein	thyroprotein
thätigkeit	thätigkeit
tieing	tieing
tighten	tighten
tightened	tightened
tightener	tightener
tighteners	tighteners
tightening	tightening
tightenings	tightenings
tightens	tightens
tighter	tighter
tightest	tightest
tightfistedness	tightfistedness
tignon	tignon
tignum	tignum
tineid	tineid
tineidae	tineidae
tineids	tineids
tineina	tineina
tineine	tineine
tingeing	tingeing
tinselwork	tinselwork
tiptoeing	tiptoeing
tiptoeingly	tiptoeingly
tiredness	tiredness
toeing	toeing
toilworn	toilworn
toothsome	toothsome
toothsomely	toothsomely
toothsomeness	toothsomeness
topflighter	topflighter
toplighted	toplighted
torchlighted	torchlighted
torheit	torheit
totuava	totuava
totum	totum
touchedness	touchedness
tracheid	tracheid
tracheidal	tracheidal
tracheide	tracheide
tracheids	tracheids
tracheitis	tracheitis
transceive	transceive
transceiver	transceiver
transceivers	transceivers
transleithan	transleithan
transportedness	transportedness
treeify	treeify
treeiness	treeiness
treeing	treeing
treiben	treiben
treibt	treibt
treillage	treillage
treille	treille
trein	trein
treinta	treinta
treitour	treitour
treitre	treitre
treize	treize
triedness	triedness
trigness	trigness
trignesses	trignesses
triodontoidei	triodontoidei
trioleic	trioleic
triolein	triolein
triricinolein	triricinolein
triteleia	triteleia
tritheism	tritheism
tritheist	tritheist
tritheistic	tritheistic
tritheistical	tritheistical
tritheite	tritheite
tritogeneia	tritogeneia
trocheeize	trocheeize
trochleiform	trochleiform
trolleite	trolleite
tropeic	tropeic
tropein	tropein
tropeine	tropeine
troubledness	troubledness
trueheartedness	trueheartedness
trueing	trueing
trumscheit	trumscheit
truncatorotund	truncatorotund
trusteeing	trusteeing
trusteeism	trusteeism
trusteing	trusteing
truthteller	truthteller
truthtelling	truthtelling
trypaneid	trypaneid
trypaneidae	trypaneidae
tuamotu	tuamotu
tuamotuan	tuamotuan
tuberculoprotein	tuberculoprotein
tucotuco	tucotuco
tueiron	tueiron
turnverein	turnverein
turtleize	turtleize
tuyuneiri	tuyuneiri
twaddleize	twaddleize
tweil	tweil
twingeing	twingeing
twinighter	twinighter
twinighters	twinighters
twohandedness	twohandedness
tylotus	tylotus
tätigkeit	tätigkeit
ughten	ughten
uhtensang	uhtensang
ultradignified	ultradignified
umbelwort	umbelwort
unabettedness	unabettedness
unabsentmindedness	unabsentmindedness
unabsolvedness	unabsolvedness
unabstractedness	unabstractedness
unaccommodatedness	unaccommodatedness
unaccomplishedness	unaccomplishedness
unaccustomedness	unaccustomedness
unacknowledgedness	unacknowledgedness
unacquaintedness	unacquaintedness
unacquittedness	unacquittedness
unadaptedness	unadaptedness
unaddictedness	unaddictedness
unadornedness	unadornedness
unadulteratedness	unadulteratedness
unadvancedness	unadvancedness
unadvisedness	unadvisedness
unaffectedness	unaffectedness
unafflictedness	unafflictedness
unaffrighted	unaffrighted
unaffrightedly	unaffrightedly
unageing	unageing
unagitatedness	unagitatedness
unagreeing	unagreeing
unalignable	unalignable
unaligned	unaligned
unalliedness	unalliedness
unamazedness	unamazedness
unanimatedness	unanimatedness
unannexedness	unannexedness
unantiquatedness	unantiquatedness
unappeasedness	unappeasedness
unapperceived	unapperceived
unapprisedness	unapprisedness
unarmedness	unarmedness
unarraignable	unarraignable
unarraignableness	unarraignableness
unarraigned	unarraigned
unashamedness	unashamedness
unassignable	unassignable
unassignably	unassignably
unassigned	unassigned
unassuredness	unassuredness
unattestedness	unattestedness
unauthorizedness	unauthorizedness
unawakenedness	unawakenedness
unbasedness	unbasedness
unbeing	unbeing
unbenighted	unbenighted
unbenign	unbenign
unbenignant	unbenignant
unbenignantly	unbenignantly
unbenignity	unbenignity
unbenignly	unbenignly
unbenignness	unbenignness
unbiasedness	unbiasedness
unbigotedness	unbigotedness
unblemishedness	unblemishedness
unblessedness	unblessedness
unblighted	unblighted
unblightedly	unblightedly
unblightedness	unblightedness
unblottedness	unblottedness
unboundedness	unboundedness
unbracedness	unbracedness
unbridledness	unbridledness
unbrightened	unbrightened
uncalculatedness	uncalculatedness
uncampaigning	uncampaigning
uncatechisedness	uncatechisedness
uncatechizedness	uncatechizedness
unceiled	unceiled
unceilinged	unceilinged
unchangedness	unchangedness
uncircumcisedness	uncircumcisedness
uncircumscribedness	uncircumscribedness
uncivilizedness	uncivilizedness
uncleansedness	uncleansedness
unclothedness	unclothedness
uncloudedness	uncloudedness
uncoatedness	uncoatedness
uncollatedness	uncollatedness
uncollectedness	uncollectedness
uncoloredness	uncoloredness
uncolouredness	uncolouredness
uncommandedness	uncommandedness
uncomplicatedness	uncomplicatedness
uncompoundedness	uncompoundedness
unconceited	unconceited
unconceitedly	unconceitedly
unconceivable	unconceivable
unconceivableness	unconceivableness
unconceivably	unconceivably
unconceived	unconceived
unconceiving	unconceiving
unconcernedness	unconcernedness
unconcertedness	unconcertedness
unconciliatedness	unconciliatedness
unconditionedness	unconditionedness
unconfinedness	unconfinedness
unconnectedness	unconnectedness
unconsecratedness	unconsecratedness
unconsideredness	unconsideredness
unconsignable	unconsignable
unconsigned	unconsigned
unconstrainedness	unconstrainedness
uncontentedness	uncontentedness
uncontestedness	uncontestedness
uncontractedness	uncontractedness
uncontrolledness	uncontrolledness
unconvertedness	unconvertedness
unconvincedness	unconvincedness
uncopyrighted	uncopyrighted
uncorruptedness	uncorruptedness
uncounterfeit	uncounterfeit
uncounterfeited	uncounterfeited
uncouthsome	uncouthsome
uncrampedness	uncrampedness
uncreatedness	uncreatedness
uncultivatedness	uncultivatedness
unculturedness	unculturedness
undatedness	undatedness
undaughter	undaughter
undaughterliness	undaughterliness
undaughterly	undaughterly
undauntedness	undauntedness
undebauchedness	undebauchedness
undecayedness	undecayedness
undeceitful	undeceitful
undeceitfully	undeceitfully
undeceitfulness	undeceitfulness
undeceivability	undeceivability
undeceivable	undeceivable
undeceivableness	undeceivableness
undeceivably	undeceivably
undeceive	undeceive
undeceived	undeceived
undeceiver	undeceiver
undeceives	undeceives
undeceiving	undeceiving
undecidedness	undecidedness
undefeatedness	undefeatedness
undefiledness	undefiledness
undefinedness	undefinedness
undeformedness	undeformedness
undeification	undeification
undeified	undeified
undeify	undeify
undeifying	undeifying
undeistical	undeistical
undejectedness	undejectedness
undelighted	undelighted
undelightedly	undelightedly
undepravedness	undepravedness
underbeing	underbeing
underceiling	underceiling
underfreight	underfreight
underhandedness	underhandedness
underivedness	underivedness
underreceiver	underreceiver
underseeing	underseeing
undersighted	undersighted
undersign	undersign
undersignalman	undersignalman
undersignalmen	undersignalmen
undersigned	undersigned
undersigner	undersigner
undersovereign	undersovereign
underweigh	underweigh
underweight	underweight
underweighted	underweighted
undeservedness	undeservedness
undesign	undesign
undesignated	undesignated
undesignative	undesignative
undesigned	undesigned
undesignedly	undesignedly
undesignedness	undesignedness
undesigning	undesigning
undesigningly	undesigningly
undesigningness	undesigningness
undeterminedness	undeterminedness
undighted	undighted
undigne	undigne
undignified	undignified
undignifiedly	undignifiedly
undignifiedness	undignifiedness
undignify	undignify
undisciplinedness	undisciplinedness
undisguisedness	undisguisedness
undisposedness	undisposedness
undisputedness	undisputedness
undissembledness	undissembledness
undistinguishedness	undistinguishedness
undistractedness	undistractedness
undisturbedness	undisturbedness
undividedness	undividedness
undivorcedness	undivorcedness
undocumentedness	undocumentedness
undoubtedness	undoubtedness
uneducatedness	uneducatedness
unei	unei
unembarrassedness	unembarrassedness
unembellishedness	unembellishedness
unencumberedness	unencumberedness
unendlichkeit	unendlichkeit
unenforcedness	unenforcedness
unenlightened	unenlightened
unenlightening	unenlightening
unenlightenment	unenlightenment
unentitledness	unentitledness
unexampledness	unexampledness
unexcusedness	unexcusedness
unexhaustedness	unexhaustedness
unexpectedness	unexpectedness
unexperiencedness	unexperiencedness
unexplainedness	unexplainedness
unexpurgatedness	unexpurgatedness
unextendedness	unextendedness
unfalsifiedness	unfalsifiedness
unfarsighted	unfarsighted
unfazedness	unfazedness
unfeeing	unfeeing
unfeignable	unfeignable
unfeignableness	unfeignableness
unfeignably	unfeignably
unfeigned	unfeigned
unfeignedly	unfeignedly
unfeignedness	unfeignedness
unfeigning	unfeigning
unfeigningly	unfeigningly
unfeigningness	unfeigningness
unfinishedness	unfinishedness
unfittedness	unfittedness
unfixedness	unfixedness
unfledgedness	unfledgedness
unfleeing	unfleeing
unforcedness	unforcedness
unforeign	unforeign
unforeseeing	unforeseeing
unforeseeingly	unforeseeingly
unforewarnedness	unforewarnedness
unforfeit	unforfeit
unforfeitable	unforfeitable
unforfeited	unforfeited
unforfeiting	unforfeiting
unforkedness	unforkedness
unfoughten	unfoughten
unfoundedness	unfoundedness
unfreeing	unfreeing
unfreeingly	unfreeingly
unfreight	unfreight
unfreighted	unfreighted
unfreighting	unfreighting
unfrequentedness	unfrequentedness
unfriendedness	unfriendedness
unfrighted	unfrighted
unfrightenable	unfrightenable
unfrightened	unfrightened
unfrightenedness	unfrightenedness
unfrightening	unfrightening
unfurnishedness	unfurnishedness
ungemein	ungemein
ungiftedness	ungiftedness
ungovernedness	ungovernedness
ungroundedness	ungroundedness
unguardedness	unguardedness
unhabituatedness	unhabituatedness
unhackneyedness	unhackneyedness
unhallowedness	unhallowedness
unhealthsome	unhealthsome
unhealthsomeness	unhealthsomeness
unheightened	unheightened
unheil	unheil
unheired	unheired
unhomogeneity	unhomogeneity
unhopedness	unhopedness
unhumbledness	unhumbledness
unhurriedness	unhurriedness
unifiedness	unifiedness
unignitable	unignitable
unignited	unignited
unignitible	unignitible
unigniting	unigniting
unignominious	unignominious
unignominiously	unignominiously
unignominiousness	unignominiousness
unignorant	unignorant
unignorantly	unignorantly
unignored	unignored
unignoring	unignoring
unimpassionedness	unimpassionedness
unimpedness	unimpedness
unimprovedness	unimprovedness
uninclosedness	uninclosedness
unincorporatedness	unincorporatedness
unindebtedness	unindebtedness
unindignant	unindignant
uninebriatedness	uninebriatedness
uninflectedness	uninflectedness
uninhabitedness	uninhabitedness
uninhibitedness	uninhibitedness
uninitiatedness	uninitiatedness
uninjuredness	uninjuredness
uninstructedness	uninstructedness
uninterestedness	uninterestedness
unintermittedness	unintermittedness
uninterruptedness	uninterruptedness
unintoxicatedness	unintoxicatedness
uninveighing	uninveighing
uninveigled	uninveigled
unitedness	unitedness
unjointedness	unjointedness
unjustifiedness	unjustifiedness
unkennedness	unkennedness
unkindledness	unkindledness
unknighted	unknighted
unlearnedness	unlearnedness
unleisured	unleisured
unleisuredness	unleisuredness
unleisurely	unleisurely
unletteredness	unletteredness
unlighted	unlighted
unlightedly	unlightedly
unlightedness	unlightedness
unlightened	unlightened
unlignified	unlignified
unlimitedness	unlimitedness
unloathsome	unloathsome
unmalignant	unmalignant
unmalignantly	unmalignantly
unmaligned	unmaligned
unmarbleize	unmarbleize
unmarbleized	unmarbleized
unmarbleizing	unmarbleizing
unmatchedness	unmatchedness
unmeasuredness	unmeasuredness
unmeltedness	unmeltedness
unmeritedness	unmeritedness
unmisconceivable	unmisconceivable
unmitigatedness	unmitigatedness
unmittelbarkeit	unmittelbarkeit
unmixedness	unmixedness
unmodifiedness	unmodifiedness
unmortifiedness	unmortifiedness
unmotivatedness	unmotivatedness
unneighbored	unneighbored
unneighborlike	unneighborlike
unneighborliness	unneighborliness
unneighborly	unneighborly
unneighbourliness	unneighbourliness
unneighbourly	unneighbourly
unnumberedness	unnumberedness
unobstructedness	unobstructedness
unoccupiedness	unoccupiedness
unopinionatedness	unopinionatedness
unoppignorated	unoppignorated
unopposedness	unopposedness
unorganizedness	unorganizedness
unoriginatedness	unoriginatedness
unpacifiedness	unpacifiedness
unpaintedness	unpaintedness
unpantheistic	unpantheistic
unpantheistical	unpantheistical
unpantheistically	unpantheistically
unparalleledness	unparalleledness
unpardonedness	unpardonedness
unperceivability	unperceivability
unperceivable	unperceivable
unperceivably	unperceivably
unperceived	unperceived
unperceivedly	unperceivedly
unperceiving	unperceiving
unperfectedness	unperfectedness
unpersuadedness	unpersuadedness
unperturbedness	unperturbedness
unpitiedness	unpitiedness
unplannedness	unplannedness
unplebeian	unplebeian
unplighted	unplighted
unpoignant	unpoignant
unpoignantly	unpoignantly
unpoignard	unpoignard
unpolishedness	unpolishedness
unpossessedness	unpossessedness
unpracticedness	unpracticedness
unprecedentedness	unprecedentedness
unpredictedness	unpredictedness
unprejudicedness	unprejudicedness
unpremeditatedness	unpremeditatedness
unpreparedness	unpreparedness
unprincipledness	unprincipledness
unproducedness	unproducedness
unprohibitedness	unprohibitedness
unpropitiatedness	unpropitiatedness
unproportionedness	unproportionedness
unprotectedness	unprotectedness
unprotuberant	unprotuberant
unprotuberantly	unprotuberantly
unprovedness	unprovedness
unprovidedness	unprovidedness
unprovokedness	unprovokedness
unpunishedness	unpunishedness
unqualifiedness	unqualifiedness
unquestionedness	unquestionedness
unreceipted	unreceipted
unreceivable	unreceivable
unreceived	unreceived
unreceiving	unreceiving
unreclaimedness	unreclaimedness
unrecordedness	unrecordedness
unredeemedness	unredeemedness
unrefinedness	unrefinedness
unreformedness	unreformedness
unreigning	unreigning
unreimbodied	unreimbodied
unrein	unrein
unreined	unreined
unreinforced	unreinforced
unreinstated	unreinstated
unreiterable	unreiterable
unreiterated	unreiterated
unreiterating	unreiterating
unreiterative	unreiterative
unrelatedness	unrelatedness
unrelievedness	unrelievedness
unrenownedness	unrenownedness
unreportedness	unreportedness
unrepresentedness	unrepresentedness
unreprovedness	unreprovedness
unrequitedness	unrequitedness
unreservedness	unreservedness
unresigned	unresigned
unresignedly	unresignedly
unresistedness	unresistedness
unresolvedness	unresolvedness
unrestrainedness	unrestrainedness
unrestrictedness	unrestrictedness
unrevealedness	unrevealedness
unrighted	unrighted
unrighteous	unrighteous
unrighteously	unrighteously
unrighteousness	unrighteousness
unrivaledness	unrivaledness
unrotund	unrotund
unruffledness	unruffledness
unruledness	unruledness
unsacredness	unsacredness
unsanctifiedness	unsanctifiedness
unsatedness	unsatedness
unsatisfiedness	unsatisfiedness
unsaturatedness	unsaturatedness
unsavoredness	unsavoredness
unscaledness	unscaledness
unscathedness	unscathedness
unschooledness	unschooledness
unsecuredness	unsecuredness
unseeing	unseeing
unseeingly	unseeingly
unseeingness	unseeingness
unsegregatedness	unsegregatedness
unseignioral	unseignioral
unseignorial	unseignorial
unseismal	unseismal
unseismic	unseismic
unseizable	unseizable
unseize	unseize
unseized	unseized
unsettledness	unsettledness
unseveredness	unseveredness
unshamefacedness	unshamefacedness
unshapedness	unshapedness
unsharedness	unsharedness
unshavedness	unshavedness
unshoeing	unshoeing
unsighted	unsighted
unsightedly	unsightedly
unsignable	unsignable
unsignaled	unsignaled
unsignalised	unsignalised
unsignalized	unsignalized
unsignalled	unsignalled
unsignatured	unsignatured
unsigned	unsigned
unsigneted	unsigneted
unsignifiable	unsignifiable
unsignificancy	unsignificancy
unsignificant	unsignificant
unsignificantly	unsignificantly
unsignificative	unsignificative
unsignified	unsignified
unsignifying	unsignifying
unskilledness	unskilledness
unslaughtered	unslaughtered
unslighted	unslighted
unsoiledness	unsoiledness
unsophisticatedness	unsophisticatedness
unsovereign	unsovereign
unspoiledness	unspoiledness
unspotlighted	unspotlighted
unspottedness	unspottedness
unstainedness	unstainedness
unstayedness	unstayedness
unstraightened	unstraightened
unstressedness	unstressedness
unstudiedness	unstudiedness
unsubduedness	unsubduedness
unsubjectedness	unsubjectedness
unsuggestedness	unsuggestedness
unsuitedness	unsuitedness
unsulliedness	unsulliedness
unsupportedness	unsupportedness
unsurfeited	unsurfeited
unsurfeiting	unsurfeiting
unsurpassedness	unsurpassedness
unsurprisedness	unsurprisedness
unsuspectedness	unsuspectedness
unswayedness	unswayedness
unsweetenedness	unsweetenedness
untaintedness	untaintedness
untamedness	untamedness
untarnishedness	untarnishedness
untereinander	untereinander
unterscheiden	unterscheiden
unterscheidet	unterscheidet
unterscheidung	unterscheidung
untheistic	untheistic
untheistical	untheistical
untheistically	untheistically
unthoughted	unthoughted
unthoughtedly	unthoughtedly
untieing	untieing
untighten	untighten
untightened	untightened
untightening	untightening
untimedness	untimedness
untoothsome	untoothsome
untoothsomeness	untoothsomeness
untouchedness	untouchedness
untrainedness	untrainedness
untrammeledness	untrammeledness
untrimmedness	untrimmedness
untroubledness	untroubledness
untutoredness	untutoredness
unusedness	unusedness
unvarnishedness	unvarnishedness
unveil	unveil
unveiled	unveiled
unveiledly	unveiledly
unveiledness	unveiledness
unveiler	unveiler
unveiling	unveiling
unveilment	unveilment
unveils	unveils
unveined	unveined
unverifiedness	unverifiedness
unversedness	unversedness
unvitiatedness	unvitiatedness
unvouchedness	unvouchedness
unwarnedness	unwarnedness
unwarrantedness	unwarrantedness
unwashedness	unwashedness
unweariedness	unweariedness
unweddedness	unweddedness
unweighability	unweighability
unweighable	unweighable
unweighableness	unweighableness
unweighed	unweighed
unweighing	unweighing
unweight	unweight
unweighted	unweighted
unweighting	unweighting
unweights	unweights
unweighty	unweighty
unwickedness	unwickedness
unwilledness	unwilledness
unwontedness	unwontedness
unworkedness	unworkedness
unworriedness	unworriedness
upbrighten	upbrighten
upliftedness	upliftedness
uplighted	uplighted
uprein	uprein
uprighted	uprighted
uprighteous	uprighteous
uprighteously	uprighteously
uprighteousness	uprighteousness
uprootedness	uprootedness
upseize	upseize
upsighted	upsighted
uraei	uraei
urceiform	urceiform
ureic	ureic
ureid	ureid
ureide	ureide
ureides	ureides
ureido	ureido
urolutein	urolutein
urophaein	urophaein
urophein	urophein
urorosein	urorosein
urteil	urteil
urteile	urteile
urtheil	urtheil
usedness	usedness
usednt	usednt
usein	usein
uterotubal	uterotubal
uveitic	uveitic
uveitis	uveitis
uveitises	uveitises
vacantheartedness	vacantheartedness
vaikkei	vaikkei
vanaheim	vanaheim
variedness	variedness
vei	vei
veia	veia
veigle	veigle
veii	veii
veil	veil
veiled	veiled
veiledly	veiledly
veiledness	veiledness
veiler	veiler
veilers	veilers
veiling	veiling
veilings	veilings
veillait	veillait
veille	veille
veiller	veiller
veilless	veilless
veilleuse	veilleuse
veillike	veillike
veilmaker	veilmaker
veilmaking	veilmaking
veils	veils
veiltail	veiltail
veily	veily
vein	vein
veinage	veinage
veinal	veinal
veinbanding	veinbanding
veine	veine
veined	veined
veiner	veiner
veiners	veiners
veinery	veinery
veines	veines
veinier	veinier
veiniest	veiniest
veininess	veininess
veining	veining
veinings	veinings
veinless	veinless
veinlet	veinlet
veinlets	veinlets
veinlike	veinlike
veinous	veinous
veins	veins
veinstone	veinstone
veinstuff	veinstuff
veinte	veinte
veinule	veinule
veinules	veinules
veinulet	veinulet
veinulets	veinulets
veinwise	veinwise
veinwork	veinwork
veiny	veiny
velleities	velleities
velleity	velleity
verbreitet	verbreitet
verbreitung	verbreitung
verein	verein
vereinigen	vereinigen
vereinigt	vereinigt
vereinigung	vereinigung
vergangenheit	vergangenheit
vergleich	vergleich
vergleichen	vergleichen
vergleichung	vergleichung
verlegenheit	verlegenheit
vermeiden	vermeiden
vermeil	vermeil
vermeils	vermeils
verscheiden	verscheiden
verscheidene	verscheidene
verschiedenheit	verschiedenheit
verteidigung	verteidigung
verzeihen	verzeihen
verzeihung	verzeihung
verzweiflung	verzweiflung
vesiculotubular	vesiculotubular
vessignon	vessignon
vexedness	vexedness
vicereine	vicereine
vieil	vieil
vieillard	vieillard
vieillards	vieillards
vieille	vieille
vieilles	vieilles
vieillesse	vieillesse
vielleicht	vielleicht
viertelein	viertelein
vigneron	vigneron
vignerons	vignerons
vignette	vignette
vignetted	vignetted
vignetter	vignetter
vignettes	vignettes
vignetting	vignetting
vignettist	vignettist
vignettists	vignettists
vignin	vignin
viimein	viimein
viimeinen	viimeinen
viimeisen	viimeisen
villein	villein
villeinage	villeinage
villeiness	villeiness
villeinhold	villeinhold
villeins	villeins
villeity	villeity
vineity	vineity
viseing	viseing
vlei	vlei
vogueing	vogueing
voicedness	voicedness
vollkommenheit	vollkommenheit
voneinander	voneinander
vorbei	vorbei
vorbereitet	vorbereitet
vorbereitung	vorbereitung
vorteil	vorteil
vorteile	vorteile
vorzugsweise	vorzugsweise
vrijheid	vrijheid
waarheid	waarheid
wachenheimer	wachenheimer
wahrheit	wahrheit
wahrscheinlich	wahrscheinlich
waldheimia	waldheimia
waldmeister	waldmeister
waldsteinia	waldsteinia
wallenstein	wallenstein
wallenstein's	wallenstein's
wallwork	wallwork
wallwort	wallwort
wanweird	wanweird
warmheartedness	warmheartedness
warrantedness	warrantedness
wasteweir	wasteweir
waterloggedness	waterloggedness
wauchted	wauchted
waughted	waughted
weakheartedness	weakheartedness
weanedness	weanedness
weariedness	weariedness
weddedness	weddedness
wednesday	wednesday
wednesdays	wednesdays
weeweeing	weeweeing
wei	wei
weib	weib
weibe	weibe
weiber	weiber
weibes	weibes
weibliche	weibliche
weiblichen	weiblichen
weibyeite	weibyeite
weich	weich
weichen	weichen
weichselwood	weichselwood
weierstrassian	weierstrassian
weigela	weigela
weigelas	weigelas
weigelia	weigelia
weigelias	weigelias
weigelite	weigelite
weigh	weigh
weigh'd	weigh'd
weighable	weighable
weighage	weighage
weighbar	weighbar
weighbauk	weighbauk
weighbeam	weighbeam
weighbridge	weighbridge
weighbridgeman	weighbridgeman
weighed	weighed
weigher	weigher
weighers	weighers
weighership	weighership
weighhouse	weighhouse
weighin	weighin
weighing	weighing
weighings	weighings
weighlock	weighlock
weighman	weighman
weighmaster	weighmaster
weighmen	weighmen
weighment	weighment
weighs	weighs
weighshaft	weighshaft
weight	weight
weightchaser	weightchaser
weighted	weighted
weightedly	weightedly
weightedness	weightedness
weighter	weighter
weighters	weighters
weightier	weightier
weightiest	weightiest
weightily	weightily
weightiness	weightiness
weighting	weighting
weightings	weightings
weightless	weightless
weightlessly	weightlessly
weightlessness	weightlessness
weightlifter	weightlifter
weightlifting	weightlifting
weightometer	weightometer
weights	weights
weightwith	weightwith
weighty	weighty
weil	weil
weilang	weilang
weile	weile
weimar	weimar
weimaraner	weimaraner
wein	wein
weinberg	weinberg
weinbergerite	weinbergerite
weinen	weinen
weinend	weinend
weiner	weiner
weiners	weiners
weinig	weinig
weinige	weinige
weinmannia	weinmannia
weinschenkite	weinschenkite
weinte	weinte
weir	weir
weirangle	weirangle
weird	weird
weirded	weirded
weirder	weirder
weirdest	weirdest
weirdful	weirdful
weirdie	weirdie
weirdies	weirdies
weirding	weirding
weirdish	weirdish
weirdless	weirdless
weirdlessness	weirdlessness
weirdlike	weirdlike
weirdliness	weirdliness
weirdly	weirdly
weirdness	weirdness
weirdo	weirdo
weirdoes	weirdoes
weirdos	weirdos
weirds	weirds
weirdsome	weirdsome
weirdward	weirdward
weirdwoman	weirdwoman
weirdwomen	weirdwomen
weirdy	weirdy
weiring	weiring
weirless	weirless
weirs	weirs
weirwood	weirwood
weisbachite	weisbachite
weise	weise
weiselbergite	weiselbergite
weisen	weisen
weisenheimer	weisenheimer
weisheit	weisheit
weism	weism
weismannian	weismannian
weismannism	weismannism
weiss	weiss
weisse	weisse
weissen	weissen
weissite	weissite
weissnichtwo	weissnichtwo
weisspriess	weisspriess
weisst	weisst
weit	weit
weite	weite
weitem	weitem
weiten	weiten
weiter	weiter
weitere	weitere
weiteren	weiteren
weiteres	weiteres
weitspekan	weitspekan
weiß	weiß
weiße	weiße
weißen	weißen
weißt	weißt
weiã	weiã
wellbeing	wellbeing
welterweight	welterweight
welterweights	welterweights
werkelijkheid	werkelijkheid
whealworm	whealworm
wheelwork	wheelwork
wheelworks	wheelworks
whein	whein
wherein	wherein
whereinsoever	whereinsoever
whereinto	whereinto
whereis	whereis
whichsoever	whichsoever
whishted	whishted
whitehall	whitehall
whitehanded	whitehanded
whitehass	whitehass
whitehawse	whitehawse
whitehead	whitehead
whiteheads	whiteheads
whiteheart	whiteheart
whitehearted	whitehearted
whitevein	whitevein
whiteveins	whiteveins
wholeheartedness	wholeheartedness
whoreishly	whoreishly
whoreishness	whoreishness
wichtigkeit	wichtigkeit
wickedness	wickedness
wifeism	wifeism
wilkeite	wilkeite
willedness	willedness
windedness	windedness
windesheimer	windesheimer
wineier	wineier
wineiest	wineiest
wingedness	wingedness
winterweight	winterweight
wirklichkeit	wirklichkeit
wiseacredness	wiseacredness
wiseacreish	wiseacreish
wiseacreishness	wiseacreishness
wiseacreism	wiseacreism
wiseheimer	wiseheimer
wisenheimer	wisenheimer
witheredness	witheredness
witherweight	witherweight
withtee	withtee
wittedness	wittedness
wizenedness	wizenedness
wobei	wobei
wocheinite	wocheinite
wodeleie	wodeleie
wontedness	wontedness
woodenheadedness	woodenheadedness
woolwork	woolwork
woolworker	woolworker
woolworking	woolworking
woolworth	woolworth
worriedness	worriedness
wretchedness	wretchedness
wrihte	wrihte
wrinkledness	wrinkledness
writhedness	writhedness
wrongheadedness	wrongheadedness
wrongheartedness	wrongheartedness
wrothsome	wrothsome
xanthein	xanthein
xantheins	xantheins
xanthoproteic	xanthoproteic
xanthoprotein	xanthoprotein
xanthoproteinic	xanthoproteinic
xenodocheion	xenodocheion
xenogeneic	xenogeneic
xylindein	xylindein
yachted	yachted
yachter	yachter
yachters	yachters
yahrzeit	yahrzeit
yahrzeits	yahrzeits
yajein	yajein
yajeine	yajeine
yankeeism	yankeeism
yankeeist	yankeeist
yankeeize	yankeeize
yenisei	yenisei
yeniseian	yeniseian
yepeleic	yepeleic
yogeeism	yogeeism
yorkshireism	yorkshireism
youthheid	youthheid
youthsome	youthsome
zahlreiche	zahlreiche
zahlreichen	zahlreichen
zechstein	zechstein
zei	zei
zeichen	zeichen
zeichnen	zeichnen
zeichnung	zeichnung
zeichnungen	zeichnungen
zeidae	zeidae
zeide	zeide
zeiden	zeiden
zeigen	zeigen
zeigt	zeigt
zeigte	zeigte
zeigten	zeigten
zeilanite	zeilanite
zeilen	zeilen
zein	zein
zeins	zeins
zeism	zeism
zeiss	zeiss
zeist	zeist
zeit	zeit
zeiten	zeiten
zeitgeist	zeitgeist
zeitlang	zeitlang
zeitschrift	zeitschrift
zeitung	zeitung
zeitungen	zeitungen
zemeism	zemeism
zeoidei	zeoidei
zigzaggedness	zigzaggedness
zippeite	zippeite
zobeide	zobeide
zollverein	zollverein
zonolimnetic	zonolimnetic
zoogloeic	zoogloeic
zootheism	zootheism
zootheist	zootheist
zootheistic	zootheistic
zubereitung	zubereitung
zufriedenheit	zufriedenheit
zugleich	zugleich
zuleika	zuleika
zuweilen	zuweilen
zwei	zwei
zweier	zweier
zweifel	zweifel
zweifeln	zweifeln
zweig	zweig
zweige	zweige
zweimal	zweimal
zweite	zweite
zweiten	zweiten
zweitens	zweitens
zweiter	zweiter
éteint	éteint
éveillé	éveillé
